CTTGCCGTTCG -> TTGCCGTTCGT
TTGCCGTTCGT -> TGCCGTTCGTA
TGCCGTTCGTA -> GCCGTTCGTAC
GCCGTTCGTAC -> CCGTTCGTACT
CCGTTCGTACT -> CGTTCGTACTT
CGTTCGTACTT -> GTTCGTACTTA
GTTCGTACTTA -> TTCGTACTTAC
TTCGTACTTAC -> TCGTACTTACA
TCGTACTTACA -> CGTACTTACAC
CGTACTTACAC -> GTACTTACACC
GTACTTACACC -> TACTTACACCG
TACTTACACCG -> ACTTACACCGG
ACTTACACCGG -> CTTACACCGGC
CTTACACCGGC -> TTACACCGGCT
TTACACCGGCT -> TACACCGGCTT
TACACCGGCTT -> ACACCGGCTTT
ACACCGGCTTT -> CACCGGCTTTT
CACCGGCTTTT -> ACCGGCTTTTC
ACCGGCTTTTC -> CCGGCTTTTCT
CCGGCTTTTCT -> CGGCTTTTCTA
CGGCTTTTCTA -> GGCTTTTCTAT
GGCTTTTCTAT -> GCTTTTCTATG
GCTTTTCTATG -> CTTTTCTATGG
CTTTTCTATGG -> TTTTCTATGGG
TTTTCTATGGG -> TTTCTATGGGG
TTTCTATGGGG -> TTCTATGGGGT
TTCTATGGGGT -> TCTATGGGGTC
TCTATGGGGTC -> CTATGGGGTCA
CTATGGGGTCA -> TATGGGGTCAC
TATGGGGTCAC -> ATGGGGTCACT
ATGGGGTCACT -> TGGGGTCACTC
TGGGGTCACTC -> GGGGTCACTCG
GGGGTCACTCG -> GGGTCACTCGG
GGGTCACTCGG -> GGTCACTCGGC
GGTCACTCGGC -> GTCACTCGGCT
GTCACTCGGCT -> TCACTCGGCTA
TCACTCGGCTA -> CACTCGGCTAG
CACTCGGCTAG -> ACTCGGCTAGT
ACTCGGCTAGT -> CTCGGCTAGTC
CTCGGCTAGTC -> TCGGCTAGTCC
TCGGCTAGTCC -> CGGCTAGTCCC
CGGCTAGTCCC -> GGCTAGTCCCT
GGCTAGTCCCT -> GCTAGTCCCTC
GCTAGTCCCTC -> CTAGTCCCTCC
CTAGTCCCTCC -> TAGTCCCTCCG
TAGTCCCTCCG -> AGTCCCTCCGT
AGTCCCTCCGT -> GTCCCTCCGTC
GTCCCTCCGTC -> TCCCTCCGTCA
TCCCTCCGTCA -> CCCTCCGTCAA
CCCTCCGTCAA -> CCTCCGTCAAG
CCTCCGTCAAG -> CTCCGTCAAGG
CTCCGTCAAGG -> TCCGTCAAGGC
TCCGTCAAGGC -> CCGTCAAGGCA
CCGTCAAGGCA -> CGTCAAGGCAG
CGTCAAGGCAG -> GTCAAGGCAGG
GTCAAGGCAGG -> TCAAGGCAGGG
TCAAGGCAGGG -> CAAGGCAGGGA
CAAGGCAGGGA -> AAGGCAGGGAC
AAGGCAGGGAC -> AGGCAGGGACA
AGGCAGGGACA -> GGCAGGGACAA
GGCAGGGACAA -> GCAGGGACAAC
GCAGGGACAAC -> CAGGGACAACA
CAGGGACAACA -> AGGGACAACAC
AGGGACAACAC -> GGGACAACACC
GGGACAACACC -> GGACAACACCA
GGACAACACCA -> GACAACACCAT
GACAACACCAT -> ACAACACCATC
ACAACACCATC -> CAACACCATCA
CAACACCATCA -> AACACCATCAT
AACACCATCAT -> ACACCATCATG
ACACCATCATG -> CACCATCATGC
CACCATCATGC -> ACCATCATGCT
ACCATCATGCT -> CCATCATGCTC
CCATCATGCTC -> CATCATGCTCA
CATCATGCTCA -> ATCATGCTCAT
ATCATGCTCAT -> TCATGCTCATA
TCATGCTCATA -> CATGCTCATAA
CATGCTCATAA -> ATGCTCATAAT
ATGCTCATAAT -> TGCTCATAATC
TGCTCATAATC -> GCTCATAATCG
GCTCATAATCG -> CTCATAATCGG
CTCATAATCGG -> TCATAATCGGA
TCATAATCGGA -> CATAATCGGAG
CATAATCGGAG -> ATAATCGGAGC
ATAATCGGAGC -> TAATCGGAGCG
TAATCGGAGCG -> AATCGGAGCGT
AATCGGAGCGT -> ATCGGAGCGTC
ATCGGAGCGTC -> TCGGAGCGTCT
TCGGAGCGTCT -> CGGAGCGTCTG
CGGAGCGTCTG -> GGAGCGTCTGG
GGAGCGTCTGG -> GAGCGTCTGGC
GAGCGTCTGGC -> AGCGTCTGGCT
AGCGTCTGGCT -> GCGTCTGGCTG
GCGTCTGGCTG -> CGTCTGGCTGC
CGTCTGGCTGC -> GTCTGGCTGCC
GTCTGGCTGCC -> TCTGGCTGCCC
TCTGGCTGCCC -> CTGGCTGCCCC
CTGGCTGCCCC -> TGGCTGCCCCA
TGGCTGCCCCA -> GGCTGCCCCAG
GGCTGCCCCAG -> GCTGCCCCAGT
GCTGCCCCAGT -> CTGCCCCAGTC
CTGCCCCAGTC -> TGCCCCAGTCA
TGCCCCAGTCA -> GCCCCAGTCAA
GCCCCAGTCAA -> CCCCAGTCAAG
CCCCAGTCAAG -> CCCAGTCAAGC
CCCAGTCAAGC -> CCAGTCAAGCC
CCAGTCAAGCC -> CAGTCAAGCCA
CAGTCAAGCCA -> AGTCAAGCCAG
AGTCAAGCCAG -> GTCAAGCCAGC
GTCAAGCCAGC -> TCAAGCCAGCC
TCAAGCCAGCC -> CAAGCCAGCCT
CAAGCCAGCCT -> AAGCCAGCCTT
AAGCCAGCCTT -> AGCCAGCCTTT
AGCCAGCCTTT -> GCCAGCCTTTA
GCCAGCCTTTA -> CCAGCCTTTAG
CCAGCCTTTAG -> CAGCCTTTAGG
CAGCCTTTAGG -> AGCCTTTAGGC
AGCCTTTAGGC -> GCCTTTAGGCC
GCCTTTAGGCC -> CCTTTAGGCCG
CCTTTAGGCCG -> CTTTAGGCCGA
CTTTAGGCCGA -> TTTAGGCCGAT
TTTAGGCCGAT -> TTAGGCCGATC
TTAGGCCGATC -> TAGGCCGATCA
TAGGCCGATCA -> AGGCCGATCAT
AGGCCGATCAT -> GGCCGATCATT
GGCCGATCATT -> GCCGATCATTA
GCCGATCATTA -> CCGATCATTAA
CCGATCATTAA -> CGATCATTAAT
CGATCATTAAT -> GATCATTAATT
GATCATTAATT -> ATCATTAATTG
ATCATTAATTG -> TCATTAATTGT
TCATTAATTGT -> CATTAATTGTT
CATTAATTGTT -> ATTAATTGTTT
ATTAATTGTTT -> TTAATTGTTTC
TTAATTGTTTC -> TAATTGTTTCC
TAATTGTTTCC -> AATTGTTTCCA
AATTGTTTCCA -> ATTGTTTCCAG
ATTGTTTCCAG -> TTGTTTCCAGC
TTGTTTCCAGC -> TGTTTCCAGCG
TGTTTCCAGCG -> GTTTCCAGCGT
GTTTCCAGCGT -> TTTCCAGCGTT
TTTCCAGCGTT -> TTCCAGCGTTG
TTCCAGCGTTG -> TCCAGCGTTGG
TCCAGCGTTGG -> CCAGCGTTGGG
CCAGCGTTGGG -> CAGCGTTGGGA
CAGCGTTGGGA -> AGCGTTGGGAA
AGCGTTGGGAA -> GCGTTGGGAAA
GCGTTGGGAAA -> CGTTGGGAAAG
CGTTGGGAAAG -> GTTGGGAAAGG
GTTGGGAAAGG -> TTGGGAAAGGT
TTGGGAAAGGT -> TGGGAAAGGTT
TGGGAAAGGTT -> GGGAAAGGTTT
GGGAAAGGTTT -> GGAAAGGTTTT
GGAAAGGTTTT -> GAAAGGTTTTG
GAAAGGTTTTG -> AAAGGTTTTGT
AAAGGTTTTGT -> AAGGTTTTGTG
AAGGTTTTGTG -> AGGTTTTGTGA
AGGTTTTGTGA -> GGTTTTGTGAC
GGTTTTGTGAC -> GTTTTGTGACG
GTTTTGTGACG -> TTTTGTGACGG
TTTTGTGACGG -> TTTGTGACGGA
TTTGTGACGGA -> TTGTGACGGAG
TTGTGACGGAG -> TGTGACGGAGT
TGTGACGGAGT -> GTGACGGAGTG
GTGACGGAGTG -> TGACGGAGTGA
TGACGGAGTGA -> GACGGAGTGAC
GACGGAGTGAC -> ACGGAGTGACA
ACGGAGTGACA -> CGGAGTGACAA
CGGAGTGACAA -> GGAGTGACAAA
GGAGTGACAAA -> GAGTGACAAAC
GAGTGACAAAC -> AGTGACAAACA
AGTGACAAACA -> GTGACAAACAC
GTGACAAACAC -> TGACAAACACC
TGACAAACACC -> GACAAACACCT
GACAAACACCT -> ACAAACACCTG
ACAAACACCTG -> CAAACACCTGG
CAAACACCTGG -> AAACACCTGGC
AAACACCTGGC -> AACACCTGGCT
AACACCTGGCT -> ACACCTGGCTG
ACACCTGGCTG -> CACCTGGCTGA
CACCTGGCTGA -> ACCTGGCTGAG
ACCTGGCTGAG -> CCTGGCTGAGG
CCTGGCTGAGG -> CTGGCTGAGGC
CTGGCTGAGGC -> TGGCTGAGGCC
TGGCTGAGGCC -> GGCTGAGGCCT
GGCTGAGGCCT -> GCTGAGGCCTC
GCTGAGGCCTC -> CTGAGGCCTCG
CTGAGGCCTCG -> TGAGGCCTCGA
TGAGGCCTCGA -> GAGGCCTCGAA
GAGGCCTCGAA -> AGGCCTCGAAT
AGGCCTCGAAT -> GGCCTCGAATA
GGCCTCGAATA -> GCCTCGAATAG
GCCTCGAATAG -> CCTCGAATAGC
CCTCGAATAGC -> CTCGAATAGCA
CTCGAATAGCA -> TCGAATAGCAC
TCGAATAGCAC -> CGAATAGCACC
CGAATAGCACC -> GAATAGCACCT
GAATAGCACCT -> AATAGCACCTA
AATAGCACCTA -> ATAGCACCTAT
ATAGCACCTAT -> TAGCACCTATG
TAGCACCTATG -> AGCACCTATGA
AGCACCTATGA -> GCACCTATGAG
GCACCTATGAG -> CACCTATGAGA
CACCTATGAGA -> ACCTATGAGAT
ACCTATGAGAT -> CCTATGAGATT
CCTATGAGATT -> CTATGAGATTG
CTATGAGATTG -> TATGAGATTGA
TATGAGATTGA -> ATGAGATTGAT
ATGAGATTGAT -> TGAGATTGATT
TGAGATTGATT -> GAGATTGATTT
GAGATTGATTT -> AGATTGATTTC
AGATTGATTTC -> GATTGATTTCG
GATTGATTTCG -> ATTGATTTCGT
ATTGATTTCGT -> TTGATTTCGTT
TTGATTTCGTT -> TGATTTCGTTA
TGATTTCGTTA -> GATTTCGTTAG
GATTTCGTTAG -> ATTTCGTTAGG
ATTTCGTTAGG -> TTTCGTTAGGC
TTTCGTTAGGC -> TTCGTTAGGCT
TTCGTTAGGCT -> TCGTTAGGCTC
TCGTTAGGCTC -> CGTTAGGCTCC
CGTTAGGCTCC -> GTTAGGCTCCG
GTTAGGCTCCG -> TTAGGCTCCGA
TTAGGCTCCGA -> TAGGCTCCGAT
TAGGCTCCGAT -> AGGCTCCGATC
AGGCTCCGATC -> GGCTCCGATCC
GGCTCCGATCC -> GCTCCGATCCA
GCTCCGATCCA -> CTCCGATCCAA
CTCCGATCCAA -> TCCGATCCAAC
TCCGATCCAAC -> CCGATCCAACC
CCGATCCAACC -> CGATCCAACCG
CGATCCAACCG -> GATCCAACCGT
GATCCAACCGT -> ATCCAACCGTC
ATCCAACCGTC -> TCCAACCGTCA
TCCAACCGTCA -> CCAACCGTCAA
CCAACCGTCAA -> CAACCGTCAAC
CAACCGTCAAC -> AACCGTCAACT
AACCGTCAACT -> ACCGTCAACTA
ACCGTCAACTA -> CCGTCAACTAC
CCGTCAACTAC -> CGTCAACTACT
CGTCAACTACT -> GTCAACTACTA
GTCAACTACTA -> TCAACTACTAT
TCAACTACTAT -> CAACTACTATC
CAACTACTATC -> AACTACTATCC
AACTACTATCC -> ACTACTATCCC
ACTACTATCCC -> CTACTATCCCT
CTACTATCCCT -> TACTATCCCTG
TACTATCCCTG -> ACTATCCCTGC
ACTATCCCTGC -> CTATCCCTGCC
CTATCCCTGCC -> TATCCCTGCCA
TATCCCTGCCA -> ATCCCTGCCAA
ATCCCTGCCAA -> TCCCTGCCAAG
TCCCTGCCAAG -> CCCTGCCAAGG
CCCTGCCAAGG -> CCTGCCAAGGC
CCTGCCAAGGC -> CTGCCAAGGCT
CTGCCAAGGCT -> TGCCAAGGCTA
TGCCAAGGCTA -> GCCAAGGCTAG
GCCAAGGCTAG -> CCAAGGCTAGC
CCAAGGCTAGC -> CAAGGCTAGCC
CAAGGCTAGCC -> AAGGCTAGCCT
AAGGCTAGCCT -> AGGCTAGCCTA
AGGCTAGCCTA -> GGCTAGCCTAT
GGCTAGCCTAT -> GCTAGCCTATT
GCTAGCCTATT -> CTAGCCTATTA
CTAGCCTATTA -> TAGCCTATTAG
TAGCCTATTAG -> AGCCTATTAGT
AGCCTATTAGT -> GCCTATTAGTA
GCCTATTAGTA -> CCTATTAGTAG
CCTATTAGTAG -> CTATTAGTAGG
CTATTAGTAGG -> TATTAGTAGGC
TATTAGTAGGC -> ATTAGTAGGCC
ATTAGTAGGCC -> TTAGTAGGCCA
TTAGTAGGCCA -> TAGTAGGCCAG
TAGTAGGCCAG -> AGTAGGCCAGT
AGTAGGCCAGT -> GTAGGCCAGTG
GTAGGCCAGTG -> TAGGCCAGTGC
TAGGCCAGTGC -> AGGCCAGTGCC
AGGCCAGTGCC -> GGCCAGTGCCG
GGCCAGTGCCG -> GCCAGTGCCGG
GCCAGTGCCGG -> CCAGTGCCGGA
CCAGTGCCGGA -> CAGTGCCGGAA
CAGTGCCGGAA -> AGTGCCGGAAC
AGTGCCGGAAC -> GTGCCGGAACC
GTGCCGGAACC -> TGCCGGAACCT
TGCCGGAACCT -> GCCGGAACCTA
GCCGGAACCTA -> CCGGAACCTAT
CCGGAACCTAT -> CGGAACCTATT
CGGAACCTATT -> GGAACCTATTG
GGAACCTATTG -> GAACCTATTGG
GAACCTATTGG -> AACCTATTGGC
AACCTATTGGC -> ACCTATTGGCA
ACCTATTGGCA -> CCTATTGGCAG
CCTATTGGCAG -> CTATTGGCAGG
CTATTGGCAGG -> TATTGGCAGGG
TATTGGCAGGG -> ATTGGCAGGGC
ATTGGCAGGGC -> TTGGCAGGGCC
TTGGCAGGGCC -> TGGCAGGGCCC
TGGCAGGGCCC -> GGCAGGGCCCT
GGCAGGGCCCT -> GCAGGGCCCTG
GCAGGGCCCTG -> CAGGGCCCTGG
CAGGGCCCTGG -> AGGGCCCTGGC
AGGGCCCTGGC -> GGGCCCTGGCT
GGGCCCTGGCT -> GGCCCTGGCTC
GGCCCTGGCTC -> GCCCTGGCTCC
GCCCTGGCTCC -> CCCTGGCTCCA
CCCTGGCTCCA -> CCTGGCTCCAT
CCTGGCTCCAT -> CTGGCTCCATG
CTGGCTCCATG -> TGGCTCCATGC
TGGCTCCATGC -> GGCTCCATGCC
GGCTCCATGCC -> GCTCCATGCCT
GCTCCATGCCT -> CTCCATGCCTA
CTCCATGCCTA -> TCCATGCCTAC
TCCATGCCTAC -> CCATGCCTACC
CCATGCCTACC -> CATGCCTACCG
CATGCCTACCG -> ATGCCTACCGA
ATGCCTACCGA -> TGCCTACCGAG
TGCCTACCGAG -> GCCTACCGAGA
GCCTACCGAGA -> CCTACCGAGAA
CCTACCGAGAA -> CTACCGAGAAT
CTACCGAGAAT -> TACCGAGAATG
TACCGAGAATG -> ACCGAGAATGG
ACCGAGAATGG -> CCGAGAATGGT
CCGAGAATGGT -> CGAGAATGGTT
CGAGAATGGTT -> GAGAATGGTTT
GAGAATGGTTT -> AGAATGGTTTG
AGAATGGTTTG -> GAATGGTTTGT
GAATGGTTTGT -> AATGGTTTGTT
AATGGTTTGTT -> ATGGTTTGTTC
ATGGTTTGTTC -> TGGTTTGTTCA
TGGTTTGTTCA -> GGTTTGTTCAG
GGTTTGTTCAG -> GTTTGTTCAGC
GTTTGTTCAGC -> TTTGTTCAGCG
TTTGTTCAGCG -> TTGTTCAGCGC
TTGTTCAGCGC -> TGTTCAGCGCT
TGTTCAGCGCT -> GTTCAGCGCTA
GTTCAGCGCTA -> TTCAGCGCTAT
TTCAGCGCTAT -> TCAGCGCTATT
TCAGCGCTATT -> CAGCGCTATTA
CAGCGCTATTA -> AGCGCTATTAG
AGCGCTATTAG -> GCGCTATTAGA
GCGCTATTAGA -> CGCTATTAGAA
CGCTATTAGAA -> GCTATTAGAAA
GCTATTAGAAA -> CTATTAGAAAG
CTATTAGAAAG -> TATTAGAAAGC
TATTAGAAAGC -> ATTAGAAAGCA
ATTAGAAAGCA -> TTAGAAAGCAA
TTAGAAAGCAA -> TAGAAAGCAAC
TAGAAAGCAAC -> AGAAAGCAACT
AGAAAGCAACT -> GAAAGCAACTA
GAAAGCAACTA -> AAAGCAACTAC
AAAGCAACTAC -> AAGCAACTACT
AAGCAACTACT -> AGCAACTACTG
AGCAACTACTG -> GCAACTACTGA
GCAACTACTGA -> CAACTACTGAC
CAACTACTGAC -> AACTACTGACT
AACTACTGACT -> ACTACTGACTA
ACTACTGACTA -> CTACTGACTAG
CTACTGACTAG -> TACTGACTAGC
TACTGACTAGC -> ACTGACTAGCC
ACTGACTAGCC -> CTGACTAGCCA
CTGACTAGCCA -> TGACTAGCCAT
TGACTAGCCAT -> GACTAGCCATA
GACTAGCCATA -> ACTAGCCATAC
ACTAGCCATAC -> CTAGCCATACA
CTAGCCATACA -> TAGCCATACAA
TAGCCATACAA -> AGCCATACAAA
AGCCATACAAA -> GCCATACAAAG
GCCATACAAAG -> CCATACAAAGT
CCATACAAAGT -> CATACAAAGTT
CATACAAAGTT -> ATACAAAGTTA
ATACAAAGTTA -> TACAAAGTTAC
TACAAAGTTAC -> ACAAAGTTACC
ACAAAGTTACC -> CAAAGTTACCA
CAAAGTTACCA -> AAAGTTACCAC
AAAGTTACCAC -> AAGTTACCACA
AAGTTACCACA -> AGTTACCACAA
AGTTACCACAA -> GTTACCACAAA
GTTACCACAAA -> TTACCACAAAT
TTACCACAAAT -> TACCACAAATA
TACCACAAATA -> ACCACAAATAC
ACCACAAATAC -> CCACAAATACA
CCACAAATACA -> CACAAATACAG
CACAAATACAG -> ACAAATACAGG
ACAAATACAGG -> CAAATACAGGG
CAAATACAGGG -> AAATACAGGGT
AAATACAGGGT -> AATACAGGGTA
AATACAGGGTA -> ATACAGGGTAG
ATACAGGGTAG -> TACAGGGTAGT
TACAGGGTAGT -> ACAGGGTAGTA
ACAGGGTAGTA -> CAGGGTAGTAC
CAGGGTAGTAC -> AGGGTAGTACC
AGGGTAGTACC -> GGGTAGTACCC
GGGTAGTACCC -> GGTAGTACCCG
GGTAGTACCCG -> GTAGTACCCGA
GTAGTACCCGA -> TAGTACCCGAA
TAGTACCCGAA -> AGTACCCGAAC
AGTACCCGAAC -> GTACCCGAACC
GTACCCGAACC -> TACCCGAACCG
TACCCGAACCG -> ACCCGAACCGT
ACCCGAACCGT -> CCCGAACCGTC
CCCGAACCGTC -> CCGAACCGTCT
CCGAACCGTCT -> CGAACCGTCTA
CGAACCGTCTA -> GAACCGTCTAA
GAACCGTCTAA -> AACCGTCTAAA
AACCGTCTAAA -> ACCGTCTAAAT
ACCGTCTAAAT -> CCGTCTAAATA
CCGTCTAAATA -> CGTCTAAATAT
CGTCTAAATAT -> GTCTAAATATA
GTCTAAATATA -> TCTAAATATAA
TCTAAATATAA -> CTAAATATAAG
CTAAATATAAG -> TAAATATAAGG
TAAATATAAGG -> AAATATAAGGA
AAATATAAGGA -> AATATAAGGAT
AATATAAGGAT -> ATATAAGGATT
ATATAAGGATT -> TATAAGGATTC
TATAAGGATTC -> ATAAGGATTCT
ATAAGGATTCT -> TAAGGATTCTT
TAAGGATTCTT -> AAGGATTCTTC
AAGGATTCTTC -> AGGATTCTTCC
AGGATTCTTCC -> GGATTCTTCCG
GGATTCTTCCG -> GATTCTTCCGT
GATTCTTCCGT -> ATTCTTCCGTA
ATTCTTCCGTA -> TTCTTCCGTAC
TTCTTCCGTAC -> TCTTCCGTACC
TCTTCCGTACC -> CTTCCGTACCC
CTTCCGTACCC -> TTCCGTACCCT
TTCCGTACCCT -> TCCGTACCCTT
TCCGTACCCTT -> CCGTACCCTTG
CCGTACCCTTG -> CGTACCCTTGG
CGTACCCTTGG -> GTACCCTTGGT
GTACCCTTGGT -> TACCCTTGGTA
TACCCTTGGTA -> ACCCTTGGTAC
ACCCTTGGTAC -> CCCTTGGTACC
CCCTTGGTACC -> CCTTGGTACCT
CCTTGGTACCT -> CTTGGTACCTT
CTTGGTACCTT -> TTGGTACCTTA
TTGGTACCTTA -> TGGTACCTTAG
TGGTACCTTAG -> GGTACCTTAGC
GGTACCTTAGC -> GTACCTTAGCC
GTACCTTAGCC -> TACCTTAGCCT
TACCTTAGCCT -> ACCTTAGCCTC
ACCTTAGCCTC -> CCTTAGCCTCC
CCTTAGCCTCC -> CTTAGCCTCCA
CTTAGCCTCCA -> TTAGCCTCCAC
TTAGCCTCCAC -> TAGCCTCCACT
TAGCCTCCACT -> AGCCTCCACTT
AGCCTCCACTT -> GCCTCCACTTG
GCCTCCACTTG -> CCTCCACTTGC
CCTCCACTTGC -> CTCCACTTGCT
CTCCACTTGCT -> TCCACTTGCTT
TCCACTTGCTT -> CCACTTGCTTG
CCACTTGCTTG -> CACTTGCTTGT
CACTTGCTTGT -> ACTTGCTTGTC
ACTTGCTTGTC -> CTTGCTTGTCT
CTTGCTTGTCT -> TTGCTTGTCTC
TTGCTTGTCTC -> TGCTTGTCTCT
TGCTTGTCTCT -> GCTTGTCTCTC
GCTTGTCTCTC -> CTTGTCTCTCT
CTTGTCTCTCT -> TTGTCTCTCTT
TTGTCTCTCTT -> TGTCTCTCTTC
TGTCTCTCTTC -> GTCTCTCTTCG
GTCTCTCTTCG -> TCTCTCTTCGC
TCTCTCTTCGC -> CTCTCTTCGCA
CTCTCTTCGCA -> TCTCTTCGCAA
TCTCTTCGCAA -> CTCTTCGCAAT
CTCTTCGCAAT -> TCTTCGCAATG
TCTTCGCAATG -> CTTCGCAATGA
CTTCGCAATGA -> TTCGCAATGAC
TTCGCAATGAC -> TCGCAATGACG
TCGCAATGACG -> CGCAATGACGA
CGCAATGACGA -> GCAATGACGAC
GCAATGACGAC -> CAATGACGACC
CAATGACGACC -> AATGACGACCA
AATGACGACCA -> ATGACGACCAG
ATGACGACCAG -> TGACGACCAGT
TGACGACCAGT -> GACGACCAGTG
GACGACCAGTG -> ACGACCAGTGG
ACGACCAGTGG -> CGACCAGTGGT
CGACCAGTGGT -> GACCAGTGGTC
GACCAGTGGTC -> ACCAGTGGTCA
ACCAGTGGTCA -> CCAGTGGTCAC
CCAGTGGTCAC -> CAGTGGTCACC
CAGTGGTCACC -> AGTGGTCACCG
AGTGGTCACCG -> GTGGTCACCGT
GTGGTCACCGT -> TGGTCACCGTT
TGGTCACCGTT -> GGTCACCGTTG
GGTCACCGTTG -> GTCACCGTTGG
GTCACCGTTGG -> TCACCGTTGGG
TCACCGTTGGG -> CACCGTTGGGT
CACCGTTGGGT -> ACCGTTGGGTA
ACCGTTGGGTA -> CCGTTGGGTAG
CCGTTGGGTAG -> CGTTGGGTAGA
CGTTGGGTAGA -> GTTGGGTAGAC
GTTGGGTAGAC -> TTGGGTAGACC
TTGGGTAGACC -> TGGGTAGACCG
TGGGTAGACCG -> GGGTAGACCGA
GGGTAGACCGA -> GGTAGACCGAG
GGTAGACCGAG -> GTAGACCGAGG
GTAGACCGAGG -> TAGACCGAGGA
TAGACCGAGGA -> AGACCGAGGAA
AGACCGAGGAA -> GACCGAGGAAA
GACCGAGGAAA -> ACCGAGGAAAG
ACCGAGGAAAG -> CCGAGGAAAGC
CCGAGGAAAGC -> CGAGGAAAGCG
CGAGGAAAGCG -> GAGGAAAGCGA
GAGGAAAGCGA -> AGGAAAGCGAA
AGGAAAGCGAA -> GGAAAGCGAAT
GGAAAGCGAAT -> GAAAGCGAATT
GAAAGCGAATT -> AAAGCGAATTA
AAAGCGAATTA -> AAGCGAATTAG
AAGCGAATTAG -> AGCGAATTAGT
AGCGAATTAGT -> GCGAATTAGTT
GCGAATTAGTT -> CGAATTAGTTT
CGAATTAGTTT -> GAATTAGTTTT
GAATTAGTTTT -> AATTAGTTTTT
AATTAGTTTTT -> ATTAGTTTTTA
ATTAGTTTTTA -> TTAGTTTTTAC
TTAGTTTTTAC -> TAGTTTTTACT
TAGTTTTTACT -> AGTTTTTACTC
AGTTTTTACTC -> GTTTTTACTCT
GTTTTTACTCT -> TTTTTACTCTC
TTTTTACTCTC -> TTTTACTCTCA
TTTTACTCTCA -> TTTACTCTCAC
TTTACTCTCAC -> TTACTCTCACG
TTACTCTCACG -> TACTCTCACGT
TACTCTCACGT -> ACTCTCACGTG
ACTCTCACGTG -> CTCTCACGTGT
CTCTCACGTGT -> TCTCACGTGTC
TCTCACGTGTC -> CTCACGTGTCT
CTCACGTGTCT -> TCACGTGTCTG
TCACGTGTCTG -> CACGTGTCTGG
CACGTGTCTGG -> ACGTGTCTGGC
ACGTGTCTGGC -> CGTGTCTGGCG
CGTGTCTGGCG -> GTGTCTGGCGG
GTGTCTGGCGG -> TGTCTGGCGGT
TGTCTGGCGGT -> GTCTGGCGGTT
GTCTGGCGGTT -> TCTGGCGGTTG
TCTGGCGGTTG -> CTGGCGGTTGA
CTGGCGGTTGA -> TGGCGGTTGAG
TGGCGGTTGAG -> GGCGGTTGAGG
GGCGGTTGAGG -> GCGGTTGAGGT
GCGGTTGAGGT -> CGGTTGAGGTG
CGGTTGAGGTG -> GGTTGAGGTGT
GGTTGAGGTGT -> GTTGAGGTGTC
GTTGAGGTGTC -> TTGAGGTGTCC
TTGAGGTGTCC -> TGAGGTGTCCC
TGAGGTGTCCC -> GAGGTGTCCCA
GAGGTGTCCCA -> AGGTGTCCCAC
AGGTGTCCCAC -> GGTGTCCCACC
GGTGTCCCACC -> GTGTCCCACCC
GTGTCCCACCC -> TGTCCCACCCA
TGTCCCACCCA -> GTCCCACCCAA
GTCCCACCCAA -> TCCCACCCAAC
TCCCACCCAAC -> CCCACCCAACG
CCCACCCAACG -> CCACCCAACGT
CCACCCAACGT -> CACCCAACGTT
CACCCAACGTT -> ACCCAACGTTA
ACCCAACGTTA -> CCCAACGTTAC
CCCAACGTTAC -> CCAACGTTACG
CCAACGTTACG -> CAACGTTACGT
CAACGTTACGT -> AACGTTACGTT
AACGTTACGTT -> ACGTTACGTTA
ACGTTACGTTA -> CGTTACGTTAT
CGTTACGTTAT -> GTTACGTTATA
GTTACGTTATA -> TTACGTTATAA
TTACGTTATAA -> TACGTTATAAT
TACGTTATAAT -> ACGTTATAATG
ACGTTATAATG -> CGTTATAATGG
CGTTATAATGG -> GTTATAATGGG
GTTATAATGGG -> TTATAATGGGC
TTATAATGGGC -> TATAATGGGCT
TATAATGGGCT -> ATAATGGGCTT
ATAATGGGCTT -> TAATGGGCTTT
TAATGGGCTTT -> AATGGGCTTTC
AATGGGCTTTC -> ATGGGCTTTCA
ATGGGCTTTCA -> TGGGCTTTCAA
TGGGCTTTCAA -> GGGCTTTCAAG
GGGCTTTCAAG -> GGCTTTCAAGA
GGCTTTCAAGA -> GCTTTCAAGAG
GCTTTCAAGAG -> CTTTCAAGAGT
CTTTCAAGAGT -> TTTCAAGAGTC
TTTCAAGAGTC -> TTCAAGAGTCA
TTCAAGAGTCA -> TCAAGAGTCAC
TCAAGAGTCAC -> CAAGAGTCACG
CAAGAGTCACG -> AAGAGTCACGA
AAGAGTCACGA -> AGAGTCACGAT
AGAGTCACGAT -> GAGTCACGATT
GAGTCACGATT -> AGTCACGATTA
AGTCACGATTA -> GTCACGATTAA
GTCACGATTAA -> TCACGATTAAT
TCACGATTAAT -> CACGATTAATA
CACGATTAATA -> ACGATTAATAA
ACGATTAATAA -> CGATTAATAAT
CGATTAATAAT -> GATTAATAATC
GATTAATAATC -> ATTAATAATCT
ATTAATAATCT -> TTAATAATCTT
TTAATAATCTT -> TAATAATCTTC
TAATAATCTTC -> AATAATCTTCA
AATAATCTTCA -> ATAATCTTCAC
ATAATCTTCAC -> TAATCTTCACT
TAATCTTCACT -> AATCTTCACTT
AATCTTCACTT -> ATCTTCACTTG
ATCTTCACTTG -> TCTTCACTTGT
TCTTCACTTGT -> CTTCACTTGTA
CTTCACTTGTA -> TTCACTTGTAG
TTCACTTGTAG -> TCACTTGTAGC
TCACTTGTAGC -> CACTTGTAGCT
CACTTGTAGCT -> ACTTGTAGCTT
ACTTGTAGCTT -> CTTGTAGCTTA
CTTGTAGCTTA -> TTGTAGCTTAG
TTGTAGCTTAG -> TGTAGCTTAGC
TGTAGCTTAGC -> GTAGCTTAGCA
GTAGCTTAGCA -> TAGCTTAGCAA
TAGCTTAGCAA -> AGCTTAGCAAG
AGCTTAGCAAG -> GCTTAGCAAGG
GCTTAGCAAGG -> CTTAGCAAGGC
CTTAGCAAGGC -> TTAGCAAGGCT
TTAGCAAGGCT -> TAGCAAGGCTA
TAGCAAGGCTA -> AGCAAGGCTAG
AGCAAGGCTAG -> GCAAGGCTAGG
GCAAGGCTAGG -> CAAGGCTAGGT
CAAGGCTAGGT -> AAGGCTAGGTC
AAGGCTAGGTC -> AGGCTAGGTCC
AGGCTAGGTCC -> GGCTAGGTCCC
GGCTAGGTCCC -> GCTAGGTCCCT
GCTAGGTCCCT -> CTAGGTCCCTT
CTAGGTCCCTT -> TAGGTCCCTTC
TAGGTCCCTTC -> AGGTCCCTTCA
AGGTCCCTTCA -> GGTCCCTTCAA
GGTCCCTTCAA -> GTCCCTTCAAA
GTCCCTTCAAA -> TCCCTTCAAAC
TCCCTTCAAAC -> CCCTTCAAACC
CCCTTCAAACC -> CCTTCAAACCT
CCTTCAAACCT -> CTTCAAACCTT
CTTCAAACCTT -> TTCAAACCTTT
TTCAAACCTTT -> TCAAACCTTTT
TCAAACCTTTT -> CAAACCTTTTC
CAAACCTTTTC -> AAACCTTTTCG
AAACCTTTTCG -> AACCTTTTCGT
AACCTTTTCGT -> ACCTTTTCGTA
ACCTTTTCGTA -> CCTTTTCGTAA
CCTTTTCGTAA -> CTTTTCGTAAG
CTTTTCGTAAG -> TTTTCGTAAGA
TTTTCGTAAGA -> TTTCGTAAGAG
TTTCGTAAGAG -> TTCGTAAGAGT
TTCGTAAGAGT -> TCGTAAGAGTT
TCGTAAGAGTT -> CGTAAGAGTTG
CGTAAGAGTTG -> GTAAGAGTTGA
GTAAGAGTTGA -> TAAGAGTTGAT
TAAGAGTTGAT -> AAGAGTTGATC
AAGAGTTGATC -> AGAGTTGATCA
AGAGTTGATCA -> GAGTTGATCAG
GAGTTGATCAG -> AGTTGATCAGT
AGTTGATCAGT -> GTTGATCAGTT
GTTGATCAGTT -> TTGATCAGTTC
TTGATCAGTTC -> TGATCAGTTCA
TGATCAGTTCA -> GATCAGTTCAA
GATCAGTTCAA -> ATCAGTTCAAT
ATCAGTTCAAT -> TCAGTTCAATT
TCAGTTCAATT -> CAGTTCAATTA
CAGTTCAATTA -> AGTTCAATTAA
AGTTCAATTAA -> GTTCAATTAAC
GTTCAATTAAC -> TTCAATTAACG
TTCAATTAACG -> TCAATTAACGC
TCAATTAACGC -> CAATTAACGCC
CAATTAACGCC -> AATTAACGCCT
AATTAACGCCT -> ATTAACGCCTA
ATTAACGCCTA -> TTAACGCCTAG
TTAACGCCTAG -> TAACGCCTAGT
TAACGCCTAGT -> AACGCCTAGTA
AACGCCTAGTA -> ACGCCTAGTAA
ACGCCTAGTAA -> CGCCTAGTAAT
CGCCTAGTAAT -> GCCTAGTAATA
GCCTAGTAATA -> CCTAGTAATAC
CCTAGTAATAC -> CTAGTAATACA
CTAGTAATACA -> TAGTAATACAG
TAGTAATACAG -> AGTAATACAGC
AGTAATACAGC -> GTAATACAGCG
GTAATACAGCG -> TAATACAGCGT
TAATACAGCGT -> AATACAGCGTA
AATACAGCGTA -> ATACAGCGTAT
ATACAGCGTAT -> TACAGCGTATA
TACAGCGTATA -> ACAGCGTATAA
ACAGCGTATAA -> CAGCGTATAAA
CAGCGTATAAA -> AGCGTATAAAG
AGCGTATAAAG -> GCGTATAAAGA
GCGTATAAAGA -> CGTATAAAGAC
CGTATAAAGAC -> GTATAAAGACA
GTATAAAGACA -> TATAAAGACAT
TATAAAGACAT -> ATAAAGACATC
ATAAAGACATC -> TAAAGACATCG
TAAAGACATCG -> AAAGACATCGC
AAAGACATCGC -> AAGACATCGCC
AAGACATCGCC -> AGACATCGCCG
AGACATCGCCG -> GACATCGCCGT
GACATCGCCGT -> ACATCGCCGTT
ACATCGCCGTT -> CATCGCCGTTT
CATCGCCGTTT -> ATCGCCGTTTT
ATCGCCGTTTT -> TCGCCGTTTTC
TCGCCGTTTTC -> CGCCGTTTTCC
CGCCGTTTTCC -> GCCGTTTTCCT
GCCGTTTTCCT -> CCGTTTTCCTG
CCGTTTTCCTG -> CGTTTTCCTGC
CGTTTTCCTGC -> GTTTTCCTGCA
GTTTTCCTGCA -> TTTTCCTGCAC
TTTTCCTGCAC -> TTTCCTGCACC
TTTCCTGCACC -> TTCCTGCACCA
TTCCTGCACCA -> TCCTGCACCAC
TCCTGCACCAC -> CCTGCACCACA
CCTGCACCACA -> CTGCACCACAT
CTGCACCACAT -> TGCACCACATG
TGCACCACATG -> GCACCACATGC
GCACCACATGC -> CACCACATGCC
CACCACATGCC -> ACCACATGCCT
ACCACATGCCT -> CCACATGCCTT
CCACATGCCTT -> CACATGCCTTC
CACATGCCTTC -> ACATGCCTTCA
ACATGCCTTCA -> CATGCCTTCAA
CATGCCTTCAA -> ATGCCTTCAAT
ATGCCTTCAAT -> TGCCTTCAATA
TGCCTTCAATA -> GCCTTCAATAT
GCCTTCAATAT -> CCTTCAATATC
CCTTCAATATC -> CTTCAATATCG
CTTCAATATCG -> TTCAATATCGC
TTCAATATCGC -> TCAATATCGCA
TCAATATCGCA -> CAATATCGCAT
CAATATCGCAT -> AATATCGCATC
AATATCGCATC -> ATATCGCATCT
ATATCGCATCT -> TATCGCATCTA
TATCGCATCTA -> ATCGCATCTAG
ATCGCATCTAG -> TCGCATCTAGC
TCGCATCTAGC -> CGCATCTAGCA
CGCATCTAGCA -> GCATCTAGCAA
GCATCTAGCAA -> CATCTAGCAAA
CATCTAGCAAA -> ATCTAGCAAAG
ATCTAGCAAAG -> TCTAGCAAAGG
TCTAGCAAAGG -> CTAGCAAAGGG
CTAGCAAAGGG -> TAGCAAAGGGC
TAGCAAAGGGC -> AGCAAAGGGCG
AGCAAAGGGCG -> GCAAAGGGCGT
GCAAAGGGCGT -> CAAAGGGCGTC
CAAAGGGCGTC -> AAAGGGCGTCG
AAAGGGCGTCG -> AAGGGCGTCGG
AAGGGCGTCGG -> AGGGCGTCGGA
AGGGCGTCGGA -> GGGCGTCGGAG
GGGCGTCGGAG -> GGCGTCGGAGA
GGCGTCGGAGA -> GCGTCGGAGAG
GCGTCGGAGAG -> CGTCGGAGAGG
CGTCGGAGAGG -> GTCGGAGAGGA
GTCGGAGAGGA -> TCGGAGAGGAC
TCGGAGAGGAC -> CGGAGAGGACC
CGGAGAGGACC -> GGAGAGGACCC
GGAGAGGACCC -> GAGAGGACCCC
GAGAGGACCCC -> AGAGGACCCCC
AGAGGACCCCC -> GAGGACCCCCT
GAGGACCCCCT -> AGGACCCCCTG
AGGACCCCCTG -> GGACCCCCTGA
GGACCCCCTGA -> GACCCCCTGAC
GACCCCCTGAC -> ACCCCCTGACT
ACCCCCTGACT -> CCCCCTGACTC
CCCCCTGACTC -> CCCCTGACTCT
CCCCTGACTCT -> CCCTGACTCTT
CCCTGACTCTT -> CCTGACTCTTA
CCTGACTCTTA -> CTGACTCTTAG
CTGACTCTTAG -> TGACTCTTAGC
TGACTCTTAGC -> GACTCTTAGCA
GACTCTTAGCA -> ACTCTTAGCAT
ACTCTTAGCAT -> CTCTTAGCATC
CTCTTAGCATC -> TCTTAGCATCC
TCTTAGCATCC -> CTTAGCATCCA
CTTAGCATCCA -> TTAGCATCCAC
TTAGCATCCAC -> TAGCATCCACA
TAGCATCCACA -> AGCATCCACAG
AGCATCCACAG -> GCATCCACAGC
GCATCCACAGC -> CATCCACAGCC
CATCCACAGCC -> ATCCACAGCCC
ATCCACAGCCC -> TCCACAGCCCC
TCCACAGCCCC -> CCACAGCCCCT
CCACAGCCCCT -> CACAGCCCCTA
CACAGCCCCTA -> ACAGCCCCTAC
ACAGCCCCTAC -> CAGCCCCTACT
CAGCCCCTACT -> AGCCCCTACTG
AGCCCCTACTG -> GCCCCTACTGT
GCCCCTACTGT -> CCCCTACTGTG
CCCCTACTGTG -> CCCTACTGTGA
CCCTACTGTGA -> CCTACTGTGAC
CCTACTGTGAC -> CTACTGTGACT
CTACTGTGACT -> TACTGTGACTC
TACTGTGACTC -> ACTGTGACTCC
ACTGTGACTCC -> CTGTGACTCCA
CTGTGACTCCA -> TGTGACTCCAC
TGTGACTCCAC -> GTGACTCCACA
GTGACTCCACA -> TGACTCCACAT
TGACTCCACAT -> GACTCCACATA
GACTCCACATA -> ACTCCACATAG
ACTCCACATAG -> CTCCACATAGT
CTCCACATAGT -> TCCACATAGTC
TCCACATAGTC -> CCACATAGTCG
CCACATAGTCG -> CACATAGTCGC
CACATAGTCGC -> ACATAGTCGCC
ACATAGTCGCC -> CATAGTCGCCC
CATAGTCGCCC -> ATAGTCGCCCA
ATAGTCGCCCA -> TAGTCGCCCAG
TAGTCGCCCAG -> AGTCGCCCAGC
AGTCGCCCAGC -> GTCGCCCAGCT
GTCGCCCAGCT -> TCGCCCAGCTG
TCGCCCAGCTG -> CGCCCAGCTGC
CGCCCAGCTGC -> GCCCAGCTGCC
GCCCAGCTGCC -> CCCAGCTGCCC
CCCAGCTGCCC -> CCAGCTGCCCG
CCAGCTGCCCG -> CAGCTGCCCGA
CAGCTGCCCGA -> AGCTGCCCGAG
AGCTGCCCGAG -> GCTGCCCGAGC
GCTGCCCGAGC -> CTGCCCGAGCA
CTGCCCGAGCA -> TGCCCGAGCAT
TGCCCGAGCAT -> GCCCGAGCATT
GCCCGAGCATT -> CCCGAGCATTA
CCCGAGCATTA -> CCGAGCATTAT
CCGAGCATTAT -> CGAGCATTATT
CGAGCATTATT -> GAGCATTATTC
GAGCATTATTC -> AGCATTATTCT
AGCATTATTCT -> GCATTATTCTC
GCATTATTCTC -> CATTATTCTCA
CATTATTCTCA -> ATTATTCTCAA
ATTATTCTCAA -> TTATTCTCAAT
TTATTCTCAAT -> TATTCTCAATA
TATTCTCAATA -> ATTCTCAATAT
ATTCTCAATAT -> TTCTCAATATA
TTCTCAATATA -> TCTCAATATAC
TCTCAATATAC -> CTCAATATACG
CTCAATATACG -> TCAATATACGA
TCAATATACGA -> CAATATACGAG
CAATATACGAG -> AATATACGAGA
AATATACGAGA -> ATATACGAGAA
ATATACGAGAA -> TATACGAGAAC
TATACGAGAAC -> ATACGAGAACC
ATACGAGAACC -> TACGAGAACCT
TACGAGAACCT -> ACGAGAACCTG
ACGAGAACCTG -> CGAGAACCTGG
CGAGAACCTGG -> GAGAACCTGGT
GAGAACCTGGT -> AGAACCTGGTA
AGAACCTGGTA -> GAACCTGGTAG
GAACCTGGTAG -> AACCTGGTAGT
AACCTGGTAGT -> ACCTGGTAGTT
ACCTGGTAGTT -> CCTGGTAGTTG
CCTGGTAGTTG -> CTGGTAGTTGA
CTGGTAGTTGA -> TGGTAGTTGAG
TGGTAGTTGAG -> GGTAGTTGAGC
GGTAGTTGAGC -> GTAGTTGAGCC
GTAGTTGAGCC -> TAGTTGAGCCG
TAGTTGAGCCG -> AGTTGAGCCGG
AGTTGAGCCGG -> GTTGAGCCGGG
GTTGAGCCGGG -> TTGAGCCGGGA
TTGAGCCGGGA -> TGAGCCGGGAA
TGAGCCGGGAA -> GAGCCGGGAAC
GAGCCGGGAAC -> AGCCGGGAACC
AGCCGGGAACC -> GCCGGGAACCT
GCCGGGAACCT -> CCGGGAACCTG
CCGGGAACCTG -> CGGGAACCTGA
CGGGAACCTGA -> GGGAACCTGAT
GGGAACCTGAT -> GGAACCTGATT
GGAACCTGATT -> GAACCTGATTG
GAACCTGATTG -> AACCTGATTGG
AACCTGATTGG -> ACCTGATTGGG
ACCTGATTGGG -> CCTGATTGGGG
CCTGATTGGGG -> CTGATTGGGGT
CTGATTGGGGT -> TGATTGGGGTG
TGATTGGGGTG -> GATTGGGGTGA
GATTGGGGTGA -> ATTGGGGTGAT, ATTGGGGTGAC
ATTGGGGTGAT -> TTGGGGTGATT
TTGGGGTGATT -> TGGGGTGATTC
TGGGGTGATTC -> GGGGTGATTCG
GGGGTGATTCG -> GGGTGATTCGC
GGGTGATTCGC -> GGTGATTCGCA
GGTGATTCGCA -> GTGATTCGCAG
GTGATTCGCAG -> TGATTCGCAGT
TGATTCGCAGT -> GATTCGCAGTG
GATTCGCAGTG -> ATTCGCAGTGT
ATTCGCAGTGT -> TTCGCAGTGTG
TTCGCAGTGTG -> TCGCAGTGTGC
TCGCAGTGTGC -> CGCAGTGTGCA
CGCAGTGTGCA -> GCAGTGTGCAC
GCAGTGTGCAC -> CAGTGTGCACC
CAGTGTGCACC -> AGTGTGCACCA
AGTGTGCACCA -> GTGTGCACCAC
GTGTGCACCAC -> TGTGCACCACA
TGTGCACCACA -> GTGCACCACAT
GTGCACCACAT -> TGCACCACATA
TGCACCACATA -> GCACCACATAA
GCACCACATAA -> CACCACATAAG
CACCACATAAG -> ACCACATAAGA
ACCACATAAGA -> CCACATAAGAG
CCACATAAGAG -> CACATAAGAGA
CACATAAGAGA -> ACATAAGAGAA
ACATAAGAGAA -> CATAAGAGAAT
CATAAGAGAAT -> ATAAGAGAATT
ATAAGAGAATT -> TAAGAGAATTA
TAAGAGAATTA -> AAGAGAATTAT
AAGAGAATTAT -> AGAGAATTATG
AGAGAATTATG -> GAGAATTATGA
GAGAATTATGA -> AGAATTATGAG
AGAATTATGAG -> GAATTATGAGA
GAATTATGAGA -> AATTATGAGAT
AATTATGAGAT -> ATTATGAGATT
ATTATGAGATT -> TTATGAGATTT
TTATGAGATTT -> TATGAGATTTC
TATGAGATTTC -> ATGAGATTTCG
ATGAGATTTCG -> TGAGATTTCGG
TGAGATTTCGG -> GAGATTTCGGA
GAGATTTCGGA -> AGATTTCGGAT
AGATTTCGGAT -> GATTTCGGATT
GATTTCGGATT -> ATTTCGGATTA
ATTTCGGATTA -> TTTCGGATTAC
TTTCGGATTAC -> TTCGGATTACG
TTCGGATTACG -> TCGGATTACGA
TCGGATTACGA -> CGGATTACGAG
CGGATTACGAG -> GGATTACGAGG
GGATTACGAGG -> GATTACGAGGA
GATTACGAGGA -> ATTACGAGGAA
ATTACGAGGAA -> TTACGAGGAAA
TTACGAGGAAA -> TACGAGGAAAG
TACGAGGAAAG -> ACGAGGAAAGA
ACGAGGAAAGA -> CGAGGAAAGAA
CGAGGAAAGAA -> GAGGAAAGAAG
GAGGAAAGAAG -> AGGAAAGAAGG
AGGAAAGAAGG -> GGAAAGAAGGT
GGAAAGAAGGT -> GAAAGAAGGTG
GAAAGAAGGTG -> AAAGAAGGTGG
AAAGAAGGTGG -> AAGAAGGTGGT
AAGAAGGTGGT -> AGAAGGTGGTC
AGAAGGTGGTC -> GAAGGTGGTCG
GAAGGTGGTCG -> AAGGTGGTCGC
AAGGTGGTCGC -> AGGTGGTCGCG
AGGTGGTCGCG -> GGTGGTCGCGG
GGTGGTCGCGG -> GTGGTCGCGGC
GTGGTCGCGGC -> TGGTCGCGGCA
TGGTCGCGGCA -> GGTCGCGGCAT
GGTCGCGGCAT -> GTCGCGGCATA
GTCGCGGCATA -> TCGCGGCATAG
TCGCGGCATAG -> CGCGGCATAGG
CGCGGCATAGG -> GCGGCATAGGG
GCGGCATAGGG -> CGGCATAGGGG
CGGCATAGGGG -> GGCATAGGGGG
GGCATAGGGGG -> GCATAGGGGGT
GCATAGGGGGT -> CATAGGGGGTC
CATAGGGGGTC -> ATAGGGGGTCA
ATAGGGGGTCA -> TAGGGGGTCAT
TAGGGGGTCAT -> AGGGGGTCATC
AGGGGGTCATC -> GGGGGTCATCT
GGGGGTCATCT -> GGGGTCATCTT
GGGGTCATCTT -> GGGTCATCTTA
GGGTCATCTTA -> GGTCATCTTAG
GGTCATCTTAG -> GTCATCTTAGG
GTCATCTTAGG -> TCATCTTAGGT
TCATCTTAGGT -> CATCTTAGGTC
CATCTTAGGTC -> ATCTTAGGTCT
ATCTTAGGTCT -> TCTTAGGTCTA
TCTTAGGTCTA -> CTTAGGTCTAG
CTTAGGTCTAG -> TTAGGTCTAGA
TTAGGTCTAGA -> TAGGTCTAGAC
TAGGTCTAGAC -> AGGTCTAGACA
AGGTCTAGACA -> GGTCTAGACAT
GGTCTAGACAT -> GTCTAGACATT
GTCTAGACATT -> TCTAGACATTG
TCTAGACATTG -> CTAGACATTGG
CTAGACATTGG -> TAGACATTGGA
TAGACATTGGA -> AGACATTGGAC
AGACATTGGAC -> GACATTGGACT
GACATTGGACT -> ACATTGGACTA
ACATTGGACTA -> CATTGGACTAA
CATTGGACTAA -> ATTGGACTAAC
ATTGGACTAAC -> TTGGACTAACG
TTGGACTAACG -> TGGACTAACGT
TGGACTAACGT -> GGACTAACGTT
GGACTAACGTT -> GACTAACGTTA
GACTAACGTTA -> ACTAACGTTAG
ACTAACGTTAG -> CTAACGTTAGC
CTAACGTTAGC -> TAACGTTAGCG
TAACGTTAGCG -> AACGTTAGCGG
AACGTTAGCGG -> ACGTTAGCGGT
ACGTTAGCGGT -> CGTTAGCGGTA
CGTTAGCGGTA -> GTTAGCGGTAG
GTTAGCGGTAG -> TTAGCGGTAGG
TTAGCGGTAGG -> TAGCGGTAGGA
TAGCGGTAGGA -> AGCGGTAGGAA
AGCGGTAGGAA -> GCGGTAGGAAC
GCGGTAGGAAC -> CGGTAGGAACA
CGGTAGGAACA -> GGTAGGAACAA
GGTAGGAACAA -> GTAGGAACAAA
GTAGGAACAAA -> TAGGAACAAAC
TAGGAACAAAC -> AGGAACAAACG
AGGAACAAACG -> GGAACAAACGT
GGAACAAACGT -> GAACAAACGTT
GAACAAACGTT -> AACAAACGTTC
AACAAACGTTC -> ACAAACGTTCT
ACAAACGTTCT -> CAAACGTTCTT
CAAACGTTCTT -> AAACGTTCTTT
AAACGTTCTTT -> AACGTTCTTTA
AACGTTCTTTA -> ACGTTCTTTAT
ACGTTCTTTAT -> CGTTCTTTATC
CGTTCTTTATC -> GTTCTTTATCG
GTTCTTTATCG -> TTCTTTATCGT
TTCTTTATCGT -> TCTTTATCGTT
TCTTTATCGTT -> CTTTATCGTTT
CTTTATCGTTT -> TTTATCGTTTG
TTTATCGTTTG -> TTATCGTTTGC
TTATCGTTTGC -> TATCGTTTGCT
TATCGTTTGCT -> ATCGTTTGCTC
ATCGTTTGCTC -> TCGTTTGCTCC
TCGTTTGCTCC -> CGTTTGCTCCA
CGTTTGCTCCA -> GTTTGCTCCAG
GTTTGCTCCAG -> TTTGCTCCAGG
TTTGCTCCAGG -> TTGCTCCAGGC
TTGCTCCAGGC -> TGCTCCAGGCG
TGCTCCAGGCG -> GCTCCAGGCGT
GCTCCAGGCGT -> CTCCAGGCGTT
CTCCAGGCGTT -> TCCAGGCGTTC
TCCAGGCGTTC -> CCAGGCGTTCA
CCAGGCGTTCA -> CAGGCGTTCAT
CAGGCGTTCAT -> AGGCGTTCATA
AGGCGTTCATA -> GGCGTTCATAG
GGCGTTCATAG -> GCGTTCATAGA
GCGTTCATAGA -> CGTTCATAGAA
CGTTCATAGAA -> GTTCATAGAAT
GTTCATAGAAT -> TTCATAGAATT
TTCATAGAATT -> TCATAGAATTC
TCATAGAATTC -> CATAGAATTCT
CATAGAATTCT -> ATAGAATTCTC
ATAGAATTCTC -> TAGAATTCTCC
TAGAATTCTCC -> AGAATTCTCCG
AGAATTCTCCG -> GAATTCTCCGG
GAATTCTCCGG -> AATTCTCCGGA
AATTCTCCGGA -> ATTCTCCGGAT
ATTCTCCGGAT -> TTCTCCGGATC
TTCTCCGGATC -> TCTCCGGATCC
TCTCCGGATCC -> CTCCGGATCCA
CTCCGGATCCA -> TCCGGATCCAG
TCCGGATCCAG -> CCGGATCCAGG
CCGGATCCAGG -> CGGATCCAGGC
CGGATCCAGGC -> GGATCCAGGCC
GGATCCAGGCC -> GATCCAGGCCG
GATCCAGGCCG -> ATCCAGGCCGC
ATCCAGGCCGC -> TCCAGGCCGCT
TCCAGGCCGCT -> CCAGGCCGCTA
CCAGGCCGCTA -> CAGGCCGCTAT
CAGGCCGCTAT -> AGGCCGCTATA
AGGCCGCTATA -> GGCCGCTATAT
GGCCGCTATAT -> GCCGCTATATC
GCCGCTATATC -> CCGCTATATCC
CCGCTATATCC -> CGCTATATCCG
CGCTATATCCG -> GCTATATCCGC
GCTATATCCGC -> CTATATCCGCC
CTATATCCGCC -> TATATCCGCCC
TATATCCGCCC -> ATATCCGCCCA
ATATCCGCCCA -> TATCCGCCCAG
TATCCGCCCAG -> ATCCGCCCAGG
ATCCGCCCAGG -> TCCGCCCAGGA
TCCGCCCAGGA -> CCGCCCAGGAA
CCGCCCAGGAA -> CGCCCAGGAAC
CGCCCAGGAAC -> GCCCAGGAACT
GCCCAGGAACT -> CCCAGGAACTG
CCCAGGAACTG -> CCAGGAACTGA
CCAGGAACTGA -> CAGGAACTGAC
CAGGAACTGAC -> AGGAACTGACA
AGGAACTGACA -> GGAACTGACAC
GGAACTGACAC -> GAACTGACACC
GAACTGACACC -> AACTGACACCA
AACTGACACCA -> ACTGACACCAA
ACTGACACCAA -> CTGACACCAAT
CTGACACCAAT -> TGACACCAATC
TGACACCAATC -> GACACCAATCG
GACACCAATCG -> ACACCAATCGT
ACACCAATCGT -> CACCAATCGTT
CACCAATCGTT -> ACCAATCGTTG
ACCAATCGTTG -> CCAATCGTTGG
CCAATCGTTGG -> CAATCGTTGGC
CAATCGTTGGC -> AATCGTTGGCG
AATCGTTGGCG -> ATCGTTGGCGC
ATCGTTGGCGC -> TCGTTGGCGCA
TCGTTGGCGCA -> CGTTGGCGCAG
CGTTGGCGCAG -> GTTGGCGCAGC
GTTGGCGCAGC -> TTGGCGCAGCT
TTGGCGCAGCT -> TGGCGCAGCTT
TGGCGCAGCTT -> GGCGCAGCTTC
GGCGCAGCTTC -> GCGCAGCTTCG
GCGCAGCTTCG -> CGCAGCTTCGG
CGCAGCTTCGG -> GCAGCTTCGGG
GCAGCTTCGGG -> CAGCTTCGGGT
CAGCTTCGGGT -> AGCTTCGGGTC
AGCTTCGGGTC -> GCTTCGGGTCA
GCTTCGGGTCA -> CTTCGGGTCAG
CTTCGGGTCAG -> TTCGGGTCAGA
TTCGGGTCAGA -> TCGGGTCAGAA
TCGGGTCAGAA -> CGGGTCAGAAT
CGGGTCAGAAT -> GGGTCAGAATG
GGGTCAGAATG -> GGTCAGAATGA
GGTCAGAATGA -> GTCAGAATGAA
GTCAGAATGAA -> TCAGAATGAAT
TCAGAATGAAT -> CAGAATGAATG
CAGAATGAATG -> AGAATGAATGT
AGAATGAATGT -> GAATGAATGTG
GAATGAATGTG -> AATGAATGTGT
AATGAATGTGT -> ATGAATGTGTT
ATGAATGTGTT -> TGAATGTGTTT
TGAATGTGTTT -> GAATGTGTTTG
GAATGTGTTTG -> AATGTGTTTGG
AATGTGTTTGG -> ATGTGTTTGGA
ATGTGTTTGGA -> TGTGTTTGGAG
TGTGTTTGGAG -> GTGTTTGGAGG
GTGTTTGGAGG -> TGTTTGGAGGT
TGTTTGGAGGT -> GTTTGGAGGTT
GTTTGGAGGTT -> TTTGGAGGTTT
TTTGGAGGTTT -> TTGGAGGTTTA
TTGGAGGTTTA -> TGGAGGTTTAG
TGGAGGTTTAG -> GGAGGTTTAGG
GGAGGTTTAGG -> GAGGTTTAGGA
GAGGTTTAGGA -> AGGTTTAGGAT
AGGTTTAGGAT -> GGTTTAGGATA
GGTTTAGGATA -> GTTTAGGATAA
GTTTAGGATAA -> TTTAGGATAAT
TTTAGGATAAT -> TTAGGATAATC
TTAGGATAATC -> TAGGATAATCT
TAGGATAATCT -> AGGATAATCTG
AGGATAATCTG -> GGATAATCTGT
GGATAATCTGT -> GATAATCTGTC
GATAATCTGTC -> ATAATCTGTCT
ATAATCTGTCT -> TAATCTGTCTC
TAATCTGTCTC -> AATCTGTCTCT
AATCTGTCTCT -> ATCTGTCTCTT
ATCTGTCTCTT -> TCTGTCTCTTT
TCTGTCTCTTT -> CTGTCTCTTTC
CTGTCTCTTTC -> TGTCTCTTTCC
TGTCTCTTTCC -> GTCTCTTTCCC
GTCTCTTTCCC -> TCTCTTTCCCA
TCTCTTTCCCA -> CTCTTTCCCAC
CTCTTTCCCAC -> TCTTTCCCACT
TCTTTCCCACT -> CTTTCCCACTT
CTTTCCCACTT -> TTTCCCACTTT
TTTCCCACTTT -> TTCCCACTTTT
TTCCCACTTTT -> TCCCACTTTTA
TCCCACTTTTA -> CCCACTTTTAC
CCCACTTTTAC -> CCACTTTTACG
CCACTTTTACG -> CACTTTTACGG
CACTTTTACGG -> ACTTTTACGGA
ACTTTTACGGA -> CTTTTACGGAT
CTTTTACGGAT -> TTTTACGGATA
TTTTACGGATA -> TTTACGGATAA
TTTACGGATAA -> TTACGGATAAA
TTACGGATAAA -> TACGGATAAAA
TACGGATAAAA -> ACGGATAAAAT
ACGGATAAAAT -> CGGATAAAATT
CGGATAAAATT -> GGATAAAATTC
GGATAAAATTC -> GATAAAATTCG
GATAAAATTCG -> ATAAAATTCGC
ATAAAATTCGC -> TAAAATTCGCC
TAAAATTCGCC -> AAAATTCGCCG
AAAATTCGCCG -> AAATTCGCCGC
AAATTCGCCGC -> AATTCGCCGCC
AATTCGCCGCC -> ATTCGCCGCCC
ATTCGCCGCCC -> TTCGCCGCCCT
TTCGCCGCCCT -> TCGCCGCCCTC
TCGCCGCCCTC -> CGCCGCCCTCC
CGCCGCCCTCC -> GCCGCCCTCCA
GCCGCCCTCCA -> CCGCCCTCCAT
CCGCCCTCCAT -> CGCCCTCCATT
CGCCCTCCATT -> GCCCTCCATTG
GCCCTCCATTG -> CCCTCCATTGG
CCCTCCATTGG -> CCTCCATTGGT
CCTCCATTGGT -> CTCCATTGGTA
CTCCATTGGTA -> TCCATTGGTAT
TCCATTGGTAT -> CCATTGGTATG
CCATTGGTATG -> CATTGGTATGG
CATTGGTATGG -> ATTGGTATGGA
ATTGGTATGGA -> TTGGTATGGAC
TTGGTATGGAC -> TGGTATGGACC
TGGTATGGACC -> GGTATGGACCC
GGTATGGACCC -> GTATGGACCCC
GTATGGACCCC -> TATGGACCCCT
TATGGACCCCT -> ATGGACCCCTG
ATGGACCCCTG -> TGGACCCCTGT
TGGACCCCTGT -> GGACCCCTGTC
GGACCCCTGTC -> GACCCCTGTCA
GACCCCTGTCA -> ACCCCTGTCAT
ACCCCTGTCAT -> CCCCTGTCATA
CCCCTGTCATA -> CCCTGTCATAA
CCCTGTCATAA -> CCTGTCATAAC
CCTGTCATAAC -> CTGTCATAACT
CTGTCATAACT -> TGTCATAACTG
TGTCATAACTG -> GTCATAACTGC
GTCATAACTGC -> TCATAACTGCC
TCATAACTGCC -> CATAACTGCCA
CATAACTGCCA -> ATAACTGCCAC
ATAACTGCCAC -> TAACTGCCACA
TAACTGCCACA -> AACTGCCACAA
AACTGCCACAA -> ACTGCCACAAT
ACTGCCACAAT -> CTGCCACAATT
CTGCCACAATT -> TGCCACAATTA
TGCCACAATTA -> GCCACAATTAC
GCCACAATTAC -> CCACAATTACG
CCACAATTACG -> CACAATTACGC
CACAATTACGC -> ACAATTACGCT
ACAATTACGCT -> CAATTACGCTT
CAATTACGCTT -> AATTACGCTTT
AATTACGCTTT -> ATTACGCTTTG
ATTACGCTTTG -> TTACGCTTTGA
TTACGCTTTGA -> TACGCTTTGAG
TACGCTTTGAG -> ACGCTTTGAGA
ACGCTTTGAGA -> CGCTTTGAGAG
CGCTTTGAGAG -> GCTTTGAGAGG
GCTTTGAGAGG -> CTTTGAGAGGC
CTTTGAGAGGC -> TTTGAGAGGCA
TTTGAGAGGCA -> TTGAGAGGCAT
TTGAGAGGCAT -> TGAGAGGCATA
TGAGAGGCATA -> GAGAGGCATAG
GAGAGGCATAG -> AGAGGCATAGT
AGAGGCATAGT -> GAGGCATAGTA
GAGGCATAGTA -> AGGCATAGTAG
AGGCATAGTAG -> GGCATAGTAGC
GGCATAGTAGC -> GCATAGTAGCT
GCATAGTAGCT -> CATAGTAGCTG
CATAGTAGCTG -> ATAGTAGCTGT
ATAGTAGCTGT -> TAGTAGCTGTA
TAGTAGCTGTA -> AGTAGCTGTAT, AGTAGCTGTAG
AGTAGCTGTAT -> GTAGCTGTATA
GTAGCTGTATA -> TAGCTGTATAG
TAGCTGTATAG -> AGCTGTATAGC
AGCTGTATAGC -> GCTGTATAGCA
GCTGTATAGCA -> CTGTATAGCAT
CTGTATAGCAT -> TGTATAGCATG
TGTATAGCATG -> GTATAGCATGA
GTATAGCATGA -> TATAGCATGAG
TATAGCATGAG -> ATAGCATGAGA
ATAGCATGAGA -> TAGCATGAGAT
TAGCATGAGAT -> AGCATGAGATG
AGCATGAGATG -> GCATGAGATGA
GCATGAGATGA -> CATGAGATGAA
CATGAGATGAA -> ATGAGATGAAA
ATGAGATGAAA -> TGAGATGAAAG
TGAGATGAAAG -> GAGATGAAAGA
GAGATGAAAGA -> AGATGAAAGAG
AGATGAAAGAG -> GATGAAAGAGC
GATGAAAGAGC -> ATGAAAGAGCA
ATGAAAGAGCA -> TGAAAGAGCAC
TGAAAGAGCAC -> GAAAGAGCACA
GAAAGAGCACA -> AAAGAGCACAC
AAAGAGCACAC -> AAGAGCACACG
AAGAGCACACG -> AGAGCACACGT
AGAGCACACGT -> GAGCACACGTT
GAGCACACGTT -> AGCACACGTTT
AGCACACGTTT -> GCACACGTTTC
GCACACGTTTC -> CACACGTTTCA
CACACGTTTCA -> ACACGTTTCAC
ACACGTTTCAC -> CACGTTTCACC
CACGTTTCACC -> ACGTTTCACCA
ACGTTTCACCA -> CGTTTCACCAC
CGTTTCACCAC -> GTTTCACCACG
GTTTCACCACG -> TTTCACCACGA
TTTCACCACGA -> TTCACCACGAG
TTCACCACGAG -> TCACCACGAGG
TCACCACGAGG -> CACCACGAGGC
CACCACGAGGC -> ACCACGAGGCT
ACCACGAGGCT -> CCACGAGGCTC
CCACGAGGCTC -> CACGAGGCTCA
CACGAGGCTCA -> ACGAGGCTCAT
ACGAGGCTCAT -> CGAGGCTCATG
CGAGGCTCATG -> GAGGCTCATGG
GAGGCTCATGG -> AGGCTCATGGT
AGGCTCATGGT -> GGCTCATGGTA
GGCTCATGGTA -> GCTCATGGTAG
GCTCATGGTAG -> CTCATGGTAGC
CTCATGGTAGC -> TCATGGTAGCA
TCATGGTAGCA -> CATGGTAGCAA
CATGGTAGCAA -> ATGGTAGCAAA
ATGGTAGCAAA -> TGGTAGCAAAG
TGGTAGCAAAG -> GGTAGCAAAGA
GGTAGCAAAGA -> GTAGCAAAGAC
GTAGCAAAGAC -> TAGCAAAGACG
TAGCAAAGACG -> AGCAAAGACGG
AGCAAAGACGG -> GCAAAGACGGT
GCAAAGACGGT -> CAAAGACGGTA
CAAAGACGGTA -> AAAGACGGTAC
AAAGACGGTAC -> AAGACGGTACT
AAGACGGTACT -> AGACGGTACTA
AGACGGTACTA -> GACGGTACTAA
GACGGTACTAA -> ACGGTACTAAC
ACGGTACTAAC -> CGGTACTAACA
CGGTACTAACA -> GGTACTAACAC
GGTACTAACAC -> GTACTAACACG
GTACTAACACG -> TACTAACACGT
TACTAACACGT -> ACTAACACGTG
ACTAACACGTG -> CTAACACGTGG
CTAACACGTGG -> TAACACGTGGT
TAACACGTGGT -> AACACGTGGTT
AACACGTGGTT -> ACACGTGGTTC
ACACGTGGTTC -> CACGTGGTTCT
CACGTGGTTCT -> ACGTGGTTCTA
ACGTGGTTCTA -> CGTGGTTCTAG
CGTGGTTCTAG -> GTGGTTCTAGA
GTGGTTCTAGA -> TGGTTCTAGAT
TGGTTCTAGAT -> GGTTCTAGATC
GGTTCTAGATC -> GTTCTAGATCA
GTTCTAGATCA -> TTCTAGATCAA
TTCTAGATCAA -> TCTAGATCAAC
TCTAGATCAAC -> CTAGATCAACG
CTAGATCAACG -> TAGATCAACGT
TAGATCAACGT -> AGATCAACGTA
AGATCAACGTA -> GATCAACGTAG
GATCAACGTAG -> ATCAACGTAGG
ATCAACGTAGG -> TCAACGTAGGT
TCAACGTAGGT -> CAACGTAGGTG
CAACGTAGGTG -> AACGTAGGTGG
AACGTAGGTGG -> ACGTAGGTGGC
ACGTAGGTGGC -> CGTAGGTGGCA
CGTAGGTGGCA -> GTAGGTGGCAT
GTAGGTGGCAT -> TAGGTGGCATC
TAGGTGGCATC -> AGGTGGCATCA
AGGTGGCATCA -> GGTGGCATCAC
GGTGGCATCAC -> GTGGCATCACT
GTGGCATCACT -> TGGCATCACTG
TGGCATCACTG -> GGCATCACTGC
GGCATCACTGC -> GCATCACTGCC
GCATCACTGCC -> CATCACTGCCT
CATCACTGCCT -> ATCACTGCCTC
ATCACTGCCTC -> TCACTGCCTCA
TCACTGCCTCA -> CACTGCCTCAA
CACTGCCTCAA -> ACTGCCTCAAG
ACTGCCTCAAG -> CTGCCTCAAGG
CTGCCTCAAGG -> TGCCTCAAGGT
TGCCTCAAGGT -> GCCTCAAGGTC
GCCTCAAGGTC -> CCTCAAGGTCA
CCTCAAGGTCA -> CTCAAGGTCAG
CTCAAGGTCAG -> TCAAGGTCAGG
TCAAGGTCAGG -> CAAGGTCAGGT
CAAGGTCAGGT -> AAGGTCAGGTC
AAGGTCAGGTC -> AGGTCAGGTCC
AGGTCAGGTCC -> GGTCAGGTCCC
GGTCAGGTCCC -> GTCAGGTCCCT
GTCAGGTCCCT -> TCAGGTCCCTG
TCAGGTCCCTG -> CAGGTCCCTGG
CAGGTCCCTGG -> AGGTCCCTGGT
AGGTCCCTGGT -> GGTCCCTGGTG
GGTCCCTGGTG -> GTCCCTGGTGG
GTCCCTGGTGG -> TCCCTGGTGGT
TCCCTGGTGGT -> CCCTGGTGGTC
CCCTGGTGGTC -> CCTGGTGGTCG
CCTGGTGGTCG -> CTGGTGGTCGT
CTGGTGGTCGT -> TGGTGGTCGTA
TGGTGGTCGTA -> GGTGGTCGTAA
GGTGGTCGTAA -> GTGGTCGTAAG
GTGGTCGTAAG -> TGGTCGTAAGT
TGGTCGTAAGT -> GGTCGTAAGTT
GGTCGTAAGTT -> GTCGTAAGTTA
GTCGTAAGTTA -> TCGTAAGTTAC
TCGTAAGTTAC -> CGTAAGTTACA
CGTAAGTTACA -> GTAAGTTACAA
GTAAGTTACAA -> TAAGTTACAAG
TAAGTTACAAG -> AAGTTACAAGA
AAGTTACAAGA -> AGTTACAAGAA
AGTTACAAGAA -> GTTACAAGAAG
GTTACAAGAAG -> TTACAAGAAGC
TTACAAGAAGC -> TACAAGAAGCA
TACAAGAAGCA -> ACAAGAAGCAA
ACAAGAAGCAA -> CAAGAAGCAAT
CAAGAAGCAAT -> AAGAAGCAATG
AAGAAGCAATG -> AGAAGCAATGA
AGAAGCAATGA -> GAAGCAATGAG
GAAGCAATGAG -> AAGCAATGAGA
AAGCAATGAGA -> AGCAATGAGAG
AGCAATGAGAG -> GCAATGAGAGG
GCAATGAGAGG -> CAATGAGAGGC
CAATGAGAGGC -> AATGAGAGGCA
AATGAGAGGCA -> ATGAGAGGCAC
ATGAGAGGCAC -> TGAGAGGCACT
TGAGAGGCACT -> GAGAGGCACTC
GAGAGGCACTC -> AGAGGCACTCC
AGAGGCACTCC -> GAGGCACTCCC
GAGGCACTCCC -> AGGCACTCCCG
AGGCACTCCCG -> GGCACTCCCGA
GGCACTCCCGA -> GCACTCCCGAG
GCACTCCCGAG -> CACTCCCGAGT
CACTCCCGAGT -> ACTCCCGAGTG
ACTCCCGAGTG -> CTCCCGAGTGT
CTCCCGAGTGT -> TCCCGAGTGTA
TCCCGAGTGTA -> CCCGAGTGTAA
CCCGAGTGTAA -> CCGAGTGTAAC
CCGAGTGTAAC -> CGAGTGTAACT
CGAGTGTAACT -> GAGTGTAACTG
GAGTGTAACTG -> AGTGTAACTGT
AGTGTAACTGT -> GTGTAACTGTA
GTGTAACTGTA -> TGTAACTGTAC
TGTAACTGTAC -> GTAACTGTACC
GTAACTGTACC -> TAACTGTACCT
TAACTGTACCT -> AACTGTACCTA
AACTGTACCTA -> ACTGTACCTAG
ACTGTACCTAG -> CTGTACCTAGT
CTGTACCTAGT -> TGTACCTAGTT
TGTACCTAGTT -> GTACCTAGTTG
GTACCTAGTTG -> TACCTAGTTGT
TACCTAGTTGT -> ACCTAGTTGTG
ACCTAGTTGTG -> CCTAGTTGTGA
CCTAGTTGTGA -> CTAGTTGTGAG
CTAGTTGTGAG -> TAGTTGTGAGG
TAGTTGTGAGG -> AGTTGTGAGGC
AGTTGTGAGGC -> GTTGTGAGGCG
GTTGTGAGGCG -> TTGTGAGGCGA
TTGTGAGGCGA -> TGTGAGGCGAT
TGTGAGGCGAT -> GTGAGGCGATC
GTGAGGCGATC -> TGAGGCGATCC
TGAGGCGATCC -> GAGGCGATCCT
GAGGCGATCCT -> AGGCGATCCTG
AGGCGATCCTG -> GGCGATCCTGA
GGCGATCCTGA -> GCGATCCTGAG
GCGATCCTGAG -> CGATCCTGAGT
CGATCCTGAGT -> GATCCTGAGTT
GATCCTGAGTT -> ATCCTGAGTTG
ATCCTGAGTTG -> TCCTGAGTTGA
TCCTGAGTTGA -> CCTGAGTTGAC
CCTGAGTTGAC -> CTGAGTTGACG
CTGAGTTGACG -> TGAGTTGACGC
TGAGTTGACGC -> GAGTTGACGCT
GAGTTGACGCT -> AGTTGACGCTG
AGTTGACGCTG -> GTTGACGCTGG
GTTGACGCTGG -> TTGACGCTGGC
TTGACGCTGGC -> TGACGCTGGCA
TGACGCTGGCA -> GACGCTGGCAC
GACGCTGGCAC -> ACGCTGGCACA
ACGCTGGCACA -> CGCTGGCACAC
CGCTGGCACAC -> GCTGGCACACT
GCTGGCACACT -> CTGGCACACTC
CTGGCACACTC -> TGGCACACTCG
TGGCACACTCG -> GGCACACTCGC
GGCACACTCGC -> GCACACTCGCA
GCACACTCGCA -> CACACTCGCAC
CACACTCGCAC -> ACACTCGCACT
ACACTCGCACT -> CACTCGCACTT
CACTCGCACTT -> ACTCGCACTTT
ACTCGCACTTT -> CTCGCACTTTA
CTCGCACTTTA -> TCGCACTTTAA
TCGCACTTTAA -> CGCACTTTAAA
CGCACTTTAAA -> GCACTTTAAAG
GCACTTTAAAG -> CACTTTAAAGG
CACTTTAAAGG -> ACTTTAAAGGG
ACTTTAAAGGG -> CTTTAAAGGGA
CTTTAAAGGGA -> TTTAAAGGGAG
TTTAAAGGGAG -> TTAAAGGGAGC
TTAAAGGGAGC -> TAAAGGGAGCA
TAAAGGGAGCA -> AAAGGGAGCAA
AAAGGGAGCAA -> AAGGGAGCAAC
AAGGGAGCAAC -> AGGGAGCAACC
AGGGAGCAACC -> GGGAGCAACCG
GGGAGCAACCG -> GGAGCAACCGA
GGAGCAACCGA -> GAGCAACCGAT
GAGCAACCGAT -> AGCAACCGATA
AGCAACCGATA -> GCAACCGATAG
GCAACCGATAG -> CAACCGATAGT
CAACCGATAGT -> AACCGATAGTT
AACCGATAGTT -> ACCGATAGTTA
ACCGATAGTTA -> CCGATAGTTAG
CCGATAGTTAG -> CGATAGTTAGA
CGATAGTTAGA -> GATAGTTAGAA
GATAGTTAGAA -> ATAGTTAGAAC
ATAGTTAGAAC -> TAGTTAGAACC
TAGTTAGAACC -> AGTTAGAACCC
AGTTAGAACCC -> GTTAGAACCCT
GTTAGAACCCT -> TTAGAACCCTT
TTAGAACCCTT -> TAGAACCCTTG
TAGAACCCTTG -> AGAACCCTTGG
AGAACCCTTGG -> GAACCCTTGGA
GAACCCTTGGA -> AACCCTTGGAG
AACCCTTGGAG -> ACCCTTGGAGA
ACCCTTGGAGA -> CCCTTGGAGAT
CCCTTGGAGAT -> CCTTGGAGATC
CCTTGGAGATC -> CTTGGAGATCA
CTTGGAGATCA -> TTGGAGATCAC
TTGGAGATCAC -> TGGAGATCACG
TGGAGATCACG -> GGAGATCACGA
GGAGATCACGA -> GAGATCACGAA
GAGATCACGAA -> AGATCACGAAC
AGATCACGAAC -> GATCACGAACG
GATCACGAACG -> ATCACGAACGG
ATCACGAACGG -> TCACGAACGGC
TCACGAACGGC -> CACGAACGGCC
CACGAACGGCC -> ACGAACGGCCA
ACGAACGGCCA -> CGAACGGCCAT
CGAACGGCCAT -> GAACGGCCATG
GAACGGCCATG -> AACGGCCATGC
AACGGCCATGC -> ACGGCCATGCA
ACGGCCATGCA -> CGGCCATGCAT
CGGCCATGCAT -> GGCCATGCATC
GGCCATGCATC -> GCCATGCATCC
GCCATGCATCC -> CCATGCATCCA
CCATGCATCCA -> CATGCATCCAA
CATGCATCCAA -> ATGCATCCAAT
ATGCATCCAAT -> TGCATCCAATC
TGCATCCAATC -> GCATCCAATCG
GCATCCAATCG -> CATCCAATCGC
CATCCAATCGC -> ATCCAATCGCT
ATCCAATCGCT -> TCCAATCGCTG
TCCAATCGCTG -> CCAATCGCTGT
CCAATCGCTGT -> CAATCGCTGTA
CAATCGCTGTA -> AATCGCTGTAG
AATCGCTGTAG -> ATCGCTGTAGA
ATCGCTGTAGA -> TCGCTGTAGAC
TCGCTGTAGAC -> CGCTGTAGACA
CGCTGTAGACA -> GCTGTAGACAC
GCTGTAGACAC -> CTGTAGACACC
CTGTAGACACC -> TGTAGACACCT
TGTAGACACCT -> GTAGACACCTA
GTAGACACCTA -> TAGACACCTAT
TAGACACCTAT -> AGACACCTATA
AGACACCTATA -> GACACCTATAG
GACACCTATAG -> ACACCTATAGC
ACACCTATAGC -> CACCTATAGCG
CACCTATAGCG -> ACCTATAGCGC
ACCTATAGCGC -> CCTATAGCGCC
CCTATAGCGCC -> CTATAGCGCCC
CTATAGCGCCC -> TATAGCGCCCA
TATAGCGCCCA -> ATAGCGCCCAA
ATAGCGCCCAA -> TAGCGCCCAAA
TAGCGCCCAAA -> AGCGCCCAAAA
AGCGCCCAAAA -> GCGCCCAAAAA
GCGCCCAAAAA -> CGCCCAAAAAG
CGCCCAAAAAG -> GCCCAAAAAGC
GCCCAAAAAGC -> CCCAAAAAGCG
CCCAAAAAGCG -> CCAAAAAGCGG
CCAAAAAGCGG -> CAAAAAGCGGG
CAAAAAGCGGG -> AAAAAGCGGGT
AAAAAGCGGGT -> AAAAGCGGGTC
AAAAGCGGGTC -> AAAGCGGGTCA
AAAGCGGGTCA -> AAGCGGGTCAG
AAGCGGGTCAG -> AGCGGGTCAGT
AGCGGGTCAGT -> GCGGGTCAGTA
GCGGGTCAGTA -> CGGGTCAGTAC
CGGGTCAGTAC -> GGGTCAGTACG
GGGTCAGTACG -> GGTCAGTACGC
GGTCAGTACGC -> GTCAGTACGCG
GTCAGTACGCG -> TCAGTACGCGT
TCAGTACGCGT -> CAGTACGCGTC
CAGTACGCGTC -> AGTACGCGTCG
AGTACGCGTCG -> GTACGCGTCGA
GTACGCGTCGA -> TACGCGTCGAA
TACGCGTCGAA -> ACGCGTCGAAA
ACGCGTCGAAA -> CGCGTCGAAAG
CGCGTCGAAAG -> GCGTCGAAAGT
GCGTCGAAAGT -> CGTCGAAAGTC
CGTCGAAAGTC -> GTCGAAAGTCA
GTCGAAAGTCA -> TCGAAAGTCAC
TCGAAAGTCAC -> CGAAAGTCACT
CGAAAGTCACT -> GAAAGTCACTG
GAAAGTCACTG -> AAAGTCACTGC
AAAGTCACTGC -> AAGTCACTGCG
AAGTCACTGCG -> AGTCACTGCGT
AGTCACTGCGT -> GTCACTGCGTT
GTCACTGCGTT -> TCACTGCGTTA
TCACTGCGTTA -> CACTGCGTTAT
CACTGCGTTAT -> ACTGCGTTATC
ACTGCGTTATC -> CTGCGTTATCC
CTGCGTTATCC -> TGCGTTATCCG
TGCGTTATCCG -> GCGTTATCCGT
GCGTTATCCGT -> CGTTATCCGTG
CGTTATCCGTG -> GTTATCCGTGT
GTTATCCGTGT -> TTATCCGTGTC
TTATCCGTGTC -> TATCCGTGTCC
TATCCGTGTCC -> ATCCGTGTCCG
ATCCGTGTCCG -> TCCGTGTCCGC
TCCGTGTCCGC -> CCGTGTCCGCT
CCGTGTCCGCT -> CGTGTCCGCTC
CGTGTCCGCTC -> GTGTCCGCTCA
GTGTCCGCTCA -> TGTCCGCTCAA
TGTCCGCTCAA -> GTCCGCTCAAT
GTCCGCTCAAT -> TCCGCTCAATC
TCCGCTCAATC -> CCGCTCAATCA
CCGCTCAATCA -> CGCTCAATCAC
CGCTCAATCAC -> GCTCAATCACG
GCTCAATCACG -> CTCAATCACGT
CTCAATCACGT -> TCAATCACGTT
TCAATCACGTT -> CAATCACGTTT
CAATCACGTTT -> AATCACGTTTT
AATCACGTTTT -> ATCACGTTTTA
ATCACGTTTTA -> TCACGTTTTAC
TCACGTTTTAC -> CACGTTTTACA
CACGTTTTACA -> ACGTTTTACAC
ACGTTTTACAC -> CGTTTTACACA
CGTTTTACACA -> GTTTTACACAA
GTTTTACACAA -> TTTTACACAAA
TTTTACACAAA -> TTTACACAAAC
TTTACACAAAC -> TTACACAAACC
TTACACAAACC -> TACACAAACCT
TACACAAACCT -> ACACAAACCTC
ACACAAACCTC -> CACAAACCTCC
CACAAACCTCC -> ACAAACCTCCT
ACAAACCTCCT -> CAAACCTCCTA
CAAACCTCCTA -> AAACCTCCTAT
AAACCTCCTAT -> AACCTCCTATC
AACCTCCTATC -> ACCTCCTATCT
ACCTCCTATCT -> CCTCCTATCTC
CCTCCTATCTC -> CTCCTATCTCT
CTCCTATCTCT -> TCCTATCTCTC
TCCTATCTCTC -> CCTATCTCTCC
CCTATCTCTCC -> CTATCTCTCCA
CTATCTCTCCA -> TATCTCTCCAC
TATCTCTCCAC -> ATCTCTCCACA
ATCTCTCCACA -> TCTCTCCACAG
TCTCTCCACAG -> CTCTCCACAGC
CTCTCCACAGC -> TCTCCACAGCG
TCTCCACAGCG -> CTCCACAGCGA
CTCCACAGCGA -> TCCACAGCGAC
TCCACAGCGAC -> CCACAGCGACC
CCACAGCGACC -> CACAGCGACCA
CACAGCGACCA -> ACAGCGACCAC
ACAGCGACCAC -> CAGCGACCACC
CAGCGACCACC -> AGCGACCACCC
AGCGACCACCC -> GCGACCACCCA
GCGACCACCCA -> CGACCACCCAG
CGACCACCCAG -> GACCACCCAGG
GACCACCCAGG -> ACCACCCAGGA
ACCACCCAGGA -> CCACCCAGGAT
CCACCCAGGAT -> CACCCAGGATT
CACCCAGGATT -> ACCCAGGATTG
ACCCAGGATTG -> CCCAGGATTGG
CCCAGGATTGG -> CCAGGATTGGG
CCAGGATTGGG -> CAGGATTGGGG
CAGGATTGGGG -> AGGATTGGGGT
AGGATTGGGGT -> GGATTGGGGTG
GGATTGGGGTG -> GATTGGGGTGA
ATTGGGGTGAC -> TTGGGGTGACA
TTGGGGTGACA -> TGGGGTGACAC
TGGGGTGACAC -> GGGGTGACACT
GGGGTGACACT -> GGGTGACACTC
GGGTGACACTC -> GGTGACACTCC
GGTGACACTCC -> GTGACACTCCC
GTGACACTCCC -> TGACACTCCCA
TGACACTCCCA -> GACACTCCCAT
GACACTCCCAT -> ACACTCCCATA
ACACTCCCATA -> CACTCCCATAC
CACTCCCATAC -> ACTCCCATACT
ACTCCCATACT -> CTCCCATACTA
CTCCCATACTA -> TCCCATACTAA
TCCCATACTAA -> CCCATACTAAA
CCCATACTAAA -> CCATACTAAAG
CCATACTAAAG -> CATACTAAAGC
CATACTAAAGC -> ATACTAAAGCC
ATACTAAAGCC -> TACTAAAGCCC
TACTAAAGCCC -> ACTAAAGCCCT
ACTAAAGCCCT -> CTAAAGCCCTA
CTAAAGCCCTA -> TAAAGCCCTAA
TAAAGCCCTAA -> AAAGCCCTAAC
AAAGCCCTAAC -> AAGCCCTAACT
AAGCCCTAACT -> AGCCCTAACTC
AGCCCTAACTC -> GCCCTAACTCA
GCCCTAACTCA -> CCCTAACTCAG
CCCTAACTCAG -> CCTAACTCAGC
CCTAACTCAGC -> CTAACTCAGCA
CTAACTCAGCA -> TAACTCAGCAG
TAACTCAGCAG -> AACTCAGCAGT
AACTCAGCAGT -> ACTCAGCAGTA
ACTCAGCAGTA -> CTCAGCAGTAG
CTCAGCAGTAG -> TCAGCAGTAGG
TCAGCAGTAGG -> CAGCAGTAGGA
CAGCAGTAGGA -> AGCAGTAGGAG
AGCAGTAGGAG -> GCAGTAGGAGT
GCAGTAGGAGT -> CAGTAGGAGTT
CAGTAGGAGTT -> AGTAGGAGTTT
AGTAGGAGTTT -> GTAGGAGTTTC
GTAGGAGTTTC -> TAGGAGTTTCC
TAGGAGTTTCC -> AGGAGTTTCCT
AGGAGTTTCCT -> GGAGTTTCCTG
GGAGTTTCCTG -> GAGTTTCCTGA
GAGTTTCCTGA -> AGTTTCCTGAA
AGTTTCCTGAA -> GTTTCCTGAAG
GTTTCCTGAAG -> TTTCCTGAAGG
TTTCCTGAAGG -> TTCCTGAAGGC
TTCCTGAAGGC -> TCCTGAAGGCC
TCCTGAAGGCC -> CCTGAAGGCCC
CCTGAAGGCCC -> CTGAAGGCCCG
CTGAAGGCCCG -> TGAAGGCCCGT
TGAAGGCCCGT -> GAAGGCCCGTC
GAAGGCCCGTC -> AAGGCCCGTCG
AAGGCCCGTCG -> AGGCCCGTCGT
AGGCCCGTCGT -> GGCCCGTCGTG
GGCCCGTCGTG -> GCCCGTCGTGT
GCCCGTCGTGT -> CCCGTCGTGTG
CCCGTCGTGTG -> CCGTCGTGTGT
CCGTCGTGTGT -> CGTCGTGTGTA
CGTCGTGTGTA -> GTCGTGTGTAC
GTCGTGTGTAC -> TCGTGTGTACT
TCGTGTGTACT -> CGTGTGTACTT
CGTGTGTACTT -> GTGTGTACTTC
GTGTGTACTTC -> TGTGTACTTCG
TGTGTACTTCG -> GTGTACTTCGT
GTGTACTTCGT -> TGTACTTCGTA
TGTACTTCGTA -> GTACTTCGTAG
GTACTTCGTAG -> TACTTCGTAGA
TACTTCGTAGA -> ACTTCGTAGAT
ACTTCGTAGAT -> CTTCGTAGATG
CTTCGTAGATG -> TTCGTAGATGT
TTCGTAGATGT -> TCGTAGATGTT
TCGTAGATGTT -> CGTAGATGTTG
CGTAGATGTTG -> GTAGATGTTGA
GTAGATGTTGA -> TAGATGTTGAA
TAGATGTTGAA -> AGATGTTGAAA
AGATGTTGAAA -> GATGTTGAAAA
GATGTTGAAAA -> ATGTTGAAAAT
ATGTTGAAAAT -> TGTTGAAAATT
TGTTGAAAATT -> GTTGAAAATTT
GTTGAAAATTT -> TTGAAAATTTA
TTGAAAATTTA -> TGAAAATTTAC
TGAAAATTTAC -> GAAAATTTACA
GAAAATTTACA -> AAAATTTACAC
AAAATTTACAC -> AAATTTACACC
AAATTTACACC -> AATTTACACCG
AATTTACACCG -> ATTTACACCGA
ATTTACACCGA -> TTTACACCGAA
TTTACACCGAA -> TTACACCGAAG
TTACACCGAAG -> TACACCGAAGT
TACACCGAAGT -> ACACCGAAGTT
ACACCGAAGTT -> CACCGAAGTTT
CACCGAAGTTT -> ACCGAAGTTTT
ACCGAAGTTTT -> CCGAAGTTTTA
CCGAAGTTTTA -> CGAAGTTTTAT
CGAAGTTTTAT -> GAAGTTTTATG
GAAGTTTTATG -> AAGTTTTATGC
AAGTTTTATGC -> AGTTTTATGCA
AGTTTTATGCA -> GTTTTATGCAG
GTTTTATGCAG -> TTTTATGCAGA
TTTTATGCAGA -> TTTATGCAGAC
TTTATGCAGAC -> TTATGCAGACT
TTATGCAGACT -> TATGCAGACTG
TATGCAGACTG -> ATGCAGACTGA
ATGCAGACTGA -> TGCAGACTGAA
TGCAGACTGAA -> GCAGACTGAAT
GCAGACTGAAT -> CAGACTGAATC
CAGACTGAATC -> AGACTGAATCC
AGACTGAATCC -> GACTGAATCCT
GACTGAATCCT -> ACTGAATCCTT
ACTGAATCCTT -> CTGAATCCTTG
CTGAATCCTTG -> TGAATCCTTGT
TGAATCCTTGT -> GAATCCTTGTA
GAATCCTTGTA -> AATCCTTGTAT
AATCCTTGTAT -> ATCCTTGTATC
ATCCTTGTATC -> TCCTTGTATCC
TCCTTGTATCC -> CCTTGTATCCA
CCTTGTATCCA -> CTTGTATCCAA
CTTGTATCCAA -> TTGTATCCAAC
TTGTATCCAAC -> TGTATCCAACA
TGTATCCAACA -> GTATCCAACAA
GTATCCAACAA -> TATCCAACAAG
TATCCAACAAG -> ATCCAACAAGA
ATCCAACAAGA -> TCCAACAAGAA
TCCAACAAGAA -> CCAACAAGAAG
CCAACAAGAAG -> CAACAAGAAGG
CAACAAGAAGG -> AACAAGAAGGT
AACAAGAAGGT -> ACAAGAAGGTG
ACAAGAAGGTG -> CAAGAAGGTGG
CAAGAAGGTGG -> AAGAAGGTGGG
AAGAAGGTGGG -> AGAAGGTGGGC
AGAAGGTGGGC -> GAAGGTGGGCG
GAAGGTGGGCG -> AAGGTGGGCGA
AAGGTGGGCGA -> AGGTGGGCGAA
AGGTGGGCGAA -> GGTGGGCGAAT
GGTGGGCGAAT -> GTGGGCGAATT
GTGGGCGAATT -> TGGGCGAATTC
TGGGCGAATTC -> GGGCGAATTCT
GGGCGAATTCT -> GGCGAATTCTG
GGCGAATTCTG -> GCGAATTCTGT
GCGAATTCTGT -> CGAATTCTGTA
CGAATTCTGTA -> GAATTCTGTAC
GAATTCTGTAC -> AATTCTGTACA
AATTCTGTACA -> ATTCTGTACAG
ATTCTGTACAG -> TTCTGTACAGC
TTCTGTACAGC -> TCTGTACAGCT
TCTGTACAGCT -> CTGTACAGCTC
CTGTACAGCTC -> TGTACAGCTCC
TGTACAGCTCC -> GTACAGCTCCT
GTACAGCTCCT -> TACAGCTCCTA
TACAGCTCCTA -> ACAGCTCCTAG
ACAGCTCCTAG -> CAGCTCCTAGT
CAGCTCCTAGT -> AGCTCCTAGTC
AGCTCCTAGTC -> GCTCCTAGTCC
GCTCCTAGTCC -> CTCCTAGTCCT
CTCCTAGTCCT -> TCCTAGTCCTT
TCCTAGTCCTT -> CCTAGTCCTTC
CCTAGTCCTTC -> CTAGTCCTTCA
CTAGTCCTTCA -> TAGTCCTTCAA
TAGTCCTTCAA -> AGTCCTTCAAA
AGTCCTTCAAA -> GTCCTTCAAAC
GTCCTTCAAAC -> TCCTTCAAACT
TCCTTCAAACT -> CCTTCAAACTA
CCTTCAAACTA -> CTTCAAACTAG
CTTCAAACTAG -> TTCAAACTAGT
TTCAAACTAGT -> TCAAACTAGTT
TCAAACTAGTT -> CAAACTAGTTC
CAAACTAGTTC -> AAACTAGTTCA
AAACTAGTTCA -> AACTAGTTCAA
AACTAGTTCAA -> ACTAGTTCAAA
ACTAGTTCAAA -> CTAGTTCAAAA
CTAGTTCAAAA -> TAGTTCAAAAC
TAGTTCAAAAC -> AGTTCAAAACA
AGTTCAAAACA -> GTTCAAAACAA
GTTCAAAACAA -> TTCAAAACAAG
TTCAAAACAAG -> TCAAAACAAGT
TCAAAACAAGT -> CAAAACAAGTG
CAAAACAAGTG -> AAAACAAGTGT
AAAACAAGTGT -> AAACAAGTGTC
AAACAAGTGTC -> AACAAGTGTCT
AACAAGTGTCT -> ACAAGTGTCTG
ACAAGTGTCTG -> CAAGTGTCTGC
CAAGTGTCTGC -> AAGTGTCTGCG
AAGTGTCTGCG -> AGTGTCTGCGT
AGTGTCTGCGT -> GTGTCTGCGTA
GTGTCTGCGTA -> TGTCTGCGTAT
TGTCTGCGTAT -> GTCTGCGTATG
GTCTGCGTATG -> TCTGCGTATGC
TCTGCGTATGC -> CTGCGTATGCA
CTGCGTATGCA -> TGCGTATGCAG
TGCGTATGCAG -> GCGTATGCAGG
GCGTATGCAGG -> CGTATGCAGGA
CGTATGCAGGA -> GTATGCAGGAC
GTATGCAGGAC -> TATGCAGGACC
TATGCAGGACC -> ATGCAGGACCT
ATGCAGGACCT -> TGCAGGACCTG
TGCAGGACCTG -> GCAGGACCTGA
GCAGGACCTGA -> CAGGACCTGAT
CAGGACCTGAT -> AGGACCTGATA
AGGACCTGATA -> GGACCTGATAC
GGACCTGATAC -> GACCTGATACT
GACCTGATACT -> ACCTGATACTC
ACCTGATACTC -> CCTGATACTCG
CCTGATACTCG -> CTGATACTCGC
CTGATACTCGC -> TGATACTCGCA
TGATACTCGCA -> GATACTCGCAA
GATACTCGCAA -> ATACTCGCAAG
ATACTCGCAAG -> TACTCGCAAGG
TACTCGCAAGG -> ACTCGCAAGGC
ACTCGCAAGGC -> CTCGCAAGGCT
CTCGCAAGGCT -> TCGCAAGGCTT
TCGCAAGGCTT -> CGCAAGGCTTA
CGCAAGGCTTA -> GCAAGGCTTAA
GCAAGGCTTAA -> CAAGGCTTAAA
CAAGGCTTAAA -> AAGGCTTAAAC
AAGGCTTAAAC -> AGGCTTAAACT
AGGCTTAAACT -> GGCTTAAACTA
GGCTTAAACTA -> GCTTAAACTAG
GCTTAAACTAG -> CTTAAACTAGT
CTTAAACTAGT -> TTAAACTAGTA
TTAAACTAGTA -> TAAACTAGTAG
TAAACTAGTAG -> AAACTAGTAGC
AAACTAGTAGC -> AACTAGTAGCT
AACTAGTAGCT -> ACTAGTAGCTG
ACTAGTAGCTG -> CTAGTAGCTGT
CTAGTAGCTGT -> TAGTAGCTGTA
AGTAGCTGTAG -> GTAGCTGTAGA
GTAGCTGTAGA -> TAGCTGTAGAG
TAGCTGTAGAG -> AGCTGTAGAGG
AGCTGTAGAGG -> GCTGTAGAGGC
GCTGTAGAGGC -> CTGTAGAGGCG
CTGTAGAGGCG -> TGTAGAGGCGT
TGTAGAGGCGT -> GTAGAGGCGTG
GTAGAGGCGTG -> TAGAGGCGTGA
TAGAGGCGTGA -> AGAGGCGTGAG
AGAGGCGTGAG -> GAGGCGTGAGC
GAGGCGTGAGC -> AGGCGTGAGCC
AGGCGTGAGCC -> GGCGTGAGCCA
GGCGTGAGCCA -> GCGTGAGCCAC
GCGTGAGCCAC -> CGTGAGCCACT
CGTGAGCCACT -> GTGAGCCACTA
GTGAGCCACTA -> TGAGCCACTAT
TGAGCCACTAT -> GAGCCACTATA
GAGCCACTATA -> AGCCACTATAT
AGCCACTATAT -> GCCACTATATG
GCCACTATATG -> CCACTATATGG
CCACTATATGG -> CACTATATGGT
CACTATATGGT -> ACTATATGGTT
ACTATATGGTT -> CTATATGGTTA
CTATATGGTTA -> TATATGGTTAT
TATATGGTTAT -> ATATGGTTATA
ATATGGTTATA -> TATGGTTATAA
TATGGTTATAA -> ATGGTTATAAC
ATGGTTATAAC -> TGGTTATAACG
TGGTTATAACG -> GGTTATAACGA
GGTTATAACGA -> GTTATAACGAG
GTTATAACGAG -> TTATAACGAGG
TTATAACGAGG -> TATAACGAGGA
TATAACGAGGA -> ATAACGAGGAC
ATAACGAGGAC -> TAACGAGGACC
TAACGAGGACC -> AACGAGGACCC
AACGAGGACCC -> ACGAGGACCCC
ACGAGGACCCC -> CGAGGACCCCG
CGAGGACCCCG -> GAGGACCCCGT
GAGGACCCCGT -> AGGACCCCGTT
AGGACCCCGTT -> GGACCCCGTTA
GGACCCCGTTA -> GACCCCGTTAG
GACCCCGTTAG -> ACCCCGTTAGT
ACCCCGTTAGT -> CCCCGTTAGTT
CCCCGTTAGTT -> CCCGTTAGTTC
CCCGTTAGTTC -> CCGTTAGTTCA
CCGTTAGTTCA -> CGTTAGTTCAG
CGTTAGTTCAG -> GTTAGTTCAGC
GTTAGTTCAGC -> TTAGTTCAGCA
TTAGTTCAGCA -> TAGTTCAGCAT
TAGTTCAGCAT -> AGTTCAGCATG
AGTTCAGCATG -> GTTCAGCATGG
GTTCAGCATGG -> TTCAGCATGGC
TTCAGCATGGC -> TCAGCATGGCC
TCAGCATGGCC -> CAGCATGGCCG
CAGCATGGCCG -> AGCATGGCCGT
AGCATGGCCGT -> GCATGGCCGTG
GCATGGCCGTG -> CATGGCCGTGC
CATGGCCGTGC -> ATGGCCGTGCA
ATGGCCGTGCA -> TGGCCGTGCAC
TGGCCGTGCAC -> GGCCGTGCACA
GGCCGTGCACA -> GCCGTGCACAC
GCCGTGCACAC -> CCGTGCACACA
CCGTGCACACA -> CGTGCACACAG
CGTGCACACAG -> GTGCACACAGA
GTGCACACAGA -> TGCACACAGAG
TGCACACAGAG -> GCACACAGAGA
GCACACAGAGA -> CACACAGAGAG
CACACAGAGAG -> ACACAGAGAGC
ACACAGAGAGC -> CACAGAGAGCA
CACAGAGAGCA -> ACAGAGAGCAC
ACAGAGAGCAC -> CAGAGAGCACA
CAGAGAGCACA -> AGAGAGCACAA
AGAGAGCACAA -> GAGAGCACAAA
GAGAGCACAAA -> AGAGCACAAAT
AGAGCACAAAT -> GAGCACAAATA
GAGCACAAATA -> AGCACAAATAA
AGCACAAATAA -> GCACAAATAAG
GCACAAATAAG -> CACAAATAAGT
CACAAATAAGT -> ACAAATAAGTA
ACAAATAAGTA -> CAAATAAGTAC
CAAATAAGTAC -> AAATAAGTACA
AAATAAGTACA -> AATAAGTACAG
AATAAGTACAG -> ATAAGTACAGT
ATAAGTACAGT -> TAAGTACAGTG
TAAGTACAGTG -> AAGTACAGTGT
AAGTACAGTGT -> AGTACAGTGTA
AGTACAGTGTA -> GTACAGTGTAC
GTACAGTGTAC -> TACAGTGTACA
TACAGTGTACA -> ACAGTGTACAG
ACAGTGTACAG -> CAGTGTACAGA
CAGTGTACAGA -> AGTGTACAGAC
AGTGTACAGAC -> GTGTACAGACT
GTGTACAGACT -> TGTACAGACTG
TGTACAGACTG -> GTACAGACTGC
GTACAGACTGC -> TACAGACTGCT
TACAGACTGCT -> ACAGACTGCTA
ACAGACTGCTA -> CAGACTGCTAC
CAGACTGCTAC -> AGACTGCTACC
AGACTGCTACC -> GACTGCTACCC
GACTGCTACCC -> ACTGCTACCCA
ACTGCTACCCA -> CTGCTACCCAT
CTGCTACCCAT -> TGCTACCCATT
TGCTACCCATT -> GCTACCCATTG
GCTACCCATTG -> CTACCCATTGT
CTACCCATTGT -> TACCCATTGTC
TACCCATTGTC -> ACCCATTGTCC
ACCCATTGTCC -> CCCATTGTCCC
CCCATTGTCCC -> CCATTGTCCCC
CCATTGTCCCC -> CATTGTCCCCC
CATTGTCCCCC -> ATTGTCCCCCC
ATTGTCCCCCC -> TTGTCCCCCCA
TTGTCCCCCCA -> TGTCCCCCCAT
TGTCCCCCCAT -> GTCCCCCCATA
GTCCCCCCATA -> TCCCCCCATAT
TCCCCCCATAT -> CCCCCCATATT
CCCCCCATATT -> CCCCCATATTG
CCCCCATATTG -> CCCCATATTGC
CCCCATATTGC -> CCCATATTGCA
CCCATATTGCA -> CCATATTGCAA
CCATATTGCAA -> CATATTGCAAA
CATATTGCAAA -> ATATTGCAAAT
ATATTGCAAAT -> TATTGCAAATT
TATTGCAAATT -> ATTGCAAATTC
ATTGCAAATTC -> TTGCAAATTCG
TTGCAAATTCG -> TGCAAATTCGT
TGCAAATTCGT -> GCAAATTCGTC
GCAAATTCGTC -> CAAATTCGTCG
CAAATTCGTCG -> AAATTCGTCGG
AAATTCGTCGG -> AATTCGTCGGG
AATTCGTCGGG -> ATTCGTCGGGG
ATTCGTCGGGG -> TTCGTCGGGGA
TTCGTCGGGGA -> TCGTCGGGGAT
TCGTCGGGGAT -> CGTCGGGGATT
CGTCGGGGATT -> GTCGGGGATTT
GTCGGGGATTT -> TCGGGGATTTG
TCGGGGATTTG -> CGGGGATTTGG
